Reynosa–McAllen_Metropolitan_Area	isPartOf	Edinburg,_Texas
2012–13_FC_Sion_season	manager	Sébastien_Fournier
Nobuyuki_Abe	successor	Mitsumasa_Yonai
Tillman_Thomas	successor	Keith_Mitchell
1997–98_Derby_County_F.C._season	ground	Pride_Park_Stadium
After_the_Fact_(album)	producer	Martin_Hannett
Thomas_Traynor	deathPlace	Mountjoy_Prison
Domingo_Arechiga	almaMater	Martin_High_School_(Laredo,_Texas)
Tony_Hatzis	team	Naoussa_F.C.
The_Thorns_of_Life	associatedBand	Crimpshrine
Orthophonic_Joy	artist	Doyle_Lawson
The_Animal_Song	producer	Savage_Garden
KWNW	sisterStation	WREC
Livin'_in_a_World_Without_You	album	Black_Roses_(The_Rasmus_album)
Arnold_Drake	award	List_of_Eisner_Award_winners
Ted_Radke	successor	Gary_Fenlon
Phantom_of_the_Rue_Morgue	starring	Patricia_Medina
Vasily_II_of_Moscow	deathPlace	Grand_Duchy_of_Moscow
Keith_Mitchell	successor	Tillman_Thomas
Alépé_Department	isPartOf	Lagunes_District
Lucretia_Garfield	president	James_A._Garfield
The_Dead_Boys	associatedMusicalArtist	Rocket_from_the_Tombs
Slug_(band)	associatedMusicalArtist	Ultra_Vivid_Scene
2000–01_Tottenham_Hotspur_F.C._season	predecessor	1999–2000_Tottenham_Hotspur_F.C._season
William_Stephens	lieutenant	C._C._Young
Feel_Fine!	subsequentWork	Like_a_Star_in_the_Night
Drive_Like_Jehu	associatedBand	Obits
Tuktoyaktuk	isPartOf	Inuvik_Region
The_Chase_(Manafest_album)	artist	Manafest
The_Dead_Boys	associatedBand	Rocket_from_the_Tombs
Glory_(Manafest_album)	artist	Manafest
Stefan_Maletić	team	Achilles_'29
Shivering_Sherlocks	starring	Kenneth_MacDonald_(American_actor)
Every_Thing_Will_Be_Fine	starring	Patrick_Bauchau
Don't_Say_Goodnight_(It's_Time_for_Love)	recordLabel	T-Neck_Records
Home_(The_Walking_Dead)	guest	Jose_Pablo_Cantillo
Cristóbal_Vaca_de_Castro	monarch	Charles_V,_Holy_Roman_Emperor
Arizona_elegans_philipi	species	Glossy_snake
My_Lonely_Town	previousWork	Ichibu_to_Zenbu/Dive
LSK_Kvinner_FK	ground	Lillestrøm
Face_of_Fact	musicalArtist	Kotoko_(musician)
Ella_Masar	team	LSK_Kvinner_FK
Roman_Catholic_Diocese_of_Gaylord	territory	Alpena_County,_Michigan
Radiotelevizija_Slovenija	owningCompany	Government_of_Slovenia
Vallinam	director	Arivazhagan_Venkatachalam
If_She_Knew_What_She_Wants	previousWork	Manic_Monday
2014_Singapore_Grand_Prix	thirdDriver	Daniel_Ricciardo
Vasil_Tachev	team	FC_Sozopol
Teddy_Boys_Don't_Knit	previousWork	Sir_Henry_at_Rawlinson_End_(recording)
Boy_Next_Door_(song)	musicalArtist	Jamelia
Vallinam	writer	Arivazhagan_Venkatachalam
The_Forge_(Star_Trek:_Enterprise)	guest	Robert_Foxworth
Bistricioara_River_(Siret)	rightTributary	Bistricioara_River_(Siret)
Battambang_District	isPartOf	Battambang_Province
Wigan_Metropolitan_Borough_Council	leader	Councillor
Silver_City_(2004_film)	editing	John_Sayles
Wellow_Brook	mouthPlace	Midford
The_Winter_Album_(NSYNC_album)	subsequentWork	No_Strings_Attached_(NSYNC_album)
Fujiko_Fujio	birthPlace	Toyama_Prefecture
Ánima_Estudios	subsidiary	Ánima_Estudios
Loch_Ken	inflow	River_Dee,_Galloway
KEPN	sisterStation	KYGO-FM
Jose_A._Velez,_Jr.	race	Maryland_Million_Classic
William_Maclay_(Pennsylvania_senator)	party	Anti-Administration_party
Leo_Araguz	birthPlace	Pharr,_Texas
Bonnybridge	councilArea	Falkirk_(council_area)
WMC_(AM)	broadcastArea	Memphis_metropolitan_area
2003–04_Luton_Town_F.C._season	season	2003–04_Football_League
Galien_River	leftTributary	Galien_River
Pagani_(automobile)	keyPerson	Horacio_Pagani_(auto_executive)
Vasily_II_of_Moscow	birthPlace	Grand_Duchy_of_Moscow
Causus_bilineatus	family	Causinae
Capnodiaceae	order	Capnodiales
Manuel_Pinto_da_Costa	primeMinister	Miguel_Trovoada
The_Proud_Family_Movie	company	Bruce_W._Smith
Tillman_Thomas	predecessor	Keith_Mitchell
Dalbeattie	lieutenancyArea	Kirkcudbrightshire
Kristian_Nushi	birthPlace	Klina
Little_Weir_River	source	Barwon_River_(New_South_Wales)
Breathe_(Faith_Hill_song)	writer	Stephanie_Bentley
Sex_and_the_City:_Original_Motion_Picture_Soundtrack	previousWork	Sex_and_the_City:_Original_Motion_Picture_Soundtrack
WREC	broadcastArea	Memphis_metropolitan_area
Ugress	bandMember	Ugress
2d_Air_Refueling_Squadron	commandStructure	Air_Mobility_Command
The_Remixes_(The_Stone_Roses_album)	producer	Martin_Hannett
Orange_Hat	bandMember	Kenny_Howes
Lou_Sagastume	managerClub	San_Antonio_Thunder
Alépé_Department	isPartOf	La_Mé
Kevin_Godley	associatedMusicalArtist	Hotlegs
WVNO-FM	sisterStation	WRGM
Swope_Park_Rangers	manager	Marc_Dos_Santos
Sarcophilus	order	Dasyuromorphia
WXKT	sisterStation	WGMG
Mackenzie_River	city	Fort_Simpson
Barry_Ditewig	birthPlace	Veenendaal
KLEW-TV	location	Moscow,_Idaho
The_Impassive_Footman	writer	John_Paddy_Carstairs
In_the_Heat_of_the_Sun	director	Jiang_Wen
Fencing_at_the_1956_Summer_Olympics_–_Men's_team_foil	nextEvent	Fencing_at_the_1960_Summer_Olympics_–_Men's_team_foil
2013–14_FC_Zenit_Saint_Petersburg_season	successor	2014–15_FC_Zenit_Saint_Petersburg_season
Chang_King-yuh	birthPlace	Xiangtan
Ian_Shepherd	associatedMusicalArtist	Royal_Philharmonic_Orchestra
Jimmy_McCulloch	associatedMusicalArtist	One_in_a_Million_(band)
Cleveland_Thunderbolts	coach	Earle_Bruce
KYGO-FM	sisterStation	KEPN
Run_to_Him	subsequentWork	Please_Don't_Ask_About_Barbara
Tojo_(song)	album	Stoneage_Romeos
Sand_bubbler_crab	family	Dotillidae
Moran,_Wyoming	isPartOf	Teton_County,_Wyoming
Hillman,_Michigan	isPartOf	Alpena_County,_Michigan
Dennis_Patrick	occupation	Character_actor
Drive_Like_Jehu	recordLabel	Headhunter_Records
Summer_Catalog	guest	Jim_O'Heir
The_Devil's_Whore	editor	Joe_Walker_(editor)
William_J._McConnell	residence	Moscow,_Idaho
Jim_and_Tonic	race	La_Coupe_de_Maisons-Laffitte
Dirty_Situation	previousWork	Miss_Me_(Mohombi_song)
Owen_Madden_(footballer)	team	Cork_Athletic_F.C.
Horacio_Pagani_(auto_executive)	occupation	Pagani_(automobile)
KGVO_(AM)	sisterStation	KENR
2006_Sport_Club_Internacional_season	currentMember	Rafael_Alves_dos_Santos
Charles_W._Whalen,_Jr.	almaMater	University_of_Dayton
KYGO-FM	owner	Bonneville_International
Wizards_at_War	series	Young_Wizards
Frederick_Muhlenberg	party	Anti-Administration_party
Cleaner_(film)	starring	Jose_Pablo_Cantillo
Dotillidae	family	Ocypodoidea
Cucumber_(TV_series)	executiveProducer	Nicola_Shindler
Procession_(New_Order_song)	producer	Martin_Hannett
Luge_at_the_1994_Winter_Olympics_–_Doubles	nextEvent	Luge_at_the_1998_Winter_Olympics_–_Doubles
Sorex	family	Shrew
Rodmond_Roblin	successor	Tobias_Norris
Balclutha,_New_Zealand	isPartOf	Clutha_District
Obits	associatedBand	Drive_Like_Jehu
Americana_Master_Series:_Best_of_the_Sugar_Hill_Years	previousWork	Workbench_Songs
148th_Infantry_Regiment_(United_States)	commandStructure	37th_Infantry_Brigade_Combat_Team_(United_States)
The_Vanished_Diamond	series	Voyages_extraordinaires
Men_with_Guns	director	John_Sayles
Shooting_at_the_1912_Summer_Olympics_–_Men's_50_metre_team_small-bore_rifle	silverMedalist	Vilhelm_Carlberg
2014–15_FC_Zenit_Saint_Petersburg_season	predecessor	2013–14_FC_Zenit_Saint_Petersburg_season
Marc_Dos_Santos	managerClub	Swope_Park_Rangers
Thiruvannamalai_(film)	starring	Vaiyapuri
Only_a_Dream	subsequentWork	Scattered_(The_Kinks_song)
VIII_Corps_(United_Kingdom)	battle	Operation_Bluecoat
Mount_Holly,_North_Carolina	isPartOf	Gaston_County,_North_Carolina
Alexander_Bannink	birthPlace	Oldenzaal
Albert_Coppé	successor	Patrick_Hillery
Ted_Radke	predecessor	Gary_Fenlon
Welcome_to_Kanagawa	guest	J._C._MacKenzie
Hugh_O'Neill_(soccer)	team	Carolina_Lightnin'
Manuel_Salz	team	Stuttgarter_Kickers_II
Tattoos_on_This_Town	album	My_Kinda_Party
Lucretia_Garfield	spouse	James_A._Garfield
Gary_Fenlon	predecessor	Ted_Radke
Elizabeth_(The_Statler_Brothers_song)	album	Today_(The_Statler_Brothers_album)
Hanatarash	recordLabel	Alchemy_Records_(Japan)
Paola,_Calabria	province	Province_of_Cosenza
Digital_(Joy_Division_song)	producer	Martin_Hannett
Kibbie_Dome	tenant	Idaho_Vandals_football
José_Hermano_Saraiva	deathPlace	Palmela
In_the_Heat_of_the_Sun	writer	Jiang_Wen
Lehigh_Line_(Conrail)	isPartOf	CSX_Transportation
Sir_Alexander_Beville_Gibbons_Stanier,_2nd_Baronet	battle	Operation_Perch
Snap,_Crackle_&_Bop	producer	Martin_Hannett
Miloš_Melicherík	formerTeam	Guildford_Flames
16th_Ohio_Infantry	battle	Battle_of_Philippi_(West_Virginia)
Pretty_Vacant	subsequentWork	Holidays_in_the_Sun_(song)
Ami_James	occupation	Tattoo_artist
Malaysia_Federal_Route_67	routeJunction	Malaysia_Federal_Route_76
KENR	sisterStation	KGVO_(AM)
Les_Amants_du_Pont-Neuf	starring	Denis_Lavant
Heart_(Yuna_Ito_album)	subsequentWork	Wish_(Yuna_Ito_album)
Obits	associatedMusicalArtist	Drive_Like_Jehu
Please_Don't_Ask_About_Barbara	previousWork	Run_to_Him
WRGM	sisterStation	WVNO-FM
Bavarian_language	languageFamily	Upper_German
2002–03_Everton_F.C._season	predecessor	2001–02_Everton_F.C._season
KCAP_(defunct)	sisterStation	KBLL_(AM)
Robert_Lowe_(musician)	associatedBand	Solitude_Aeturnus
Cory_Gibbs	team	Brown_Bears
Augustus_II_the_Strong	parent	John_George_III,_Elector_of_Saxony
7flix	sisterStation	7TWO
Banacek	starring	George_Murdock_(actor)
Dale-class_oiler	type	Replenishment_oiler
Rocket_from_the_Tombs	associatedBand	The_Dead_Boys
Mario_Barco	team	UD_Somozas
Revision3	owner	Discovery_Digital_Networks
Ellicott_City,_Maryland	governmentType	County_council
Keith_Mitchell	primeMinister	Tillman_Thomas
Ernst_Rüdiger_Starhemberg	deathPlace	Schruns
1999–2000_Tottenham_Hotspur_F.C._season	successor	2000–01_Tottenham_Hotspur_F.C._season
Bumpy_Ride	subsequentWork	Miss_Me_(Mohombi_song)
Goa_University	affiliation	User-generated_content
U.S._Route_18_in_Iowa	routeJunction	Algona,_Iowa
Grus_(genus)	family	Crane_(bird)
Uncle_Walter_(song)	recordLabel	Passenger_Records
Lord_of_the_Rings:_Game_One	computingPlatform	Amstrad_PCW
Try_with_Me	album	Killer_Love
John_George_II,_Duke_of_Saxe-Eisenach	predecessor	John_George_I,_Duke_of_Saxe-Eisenach
Miami_Mile_Handicap	location	Calder_Race_Course
Vijay_(1989_film)	director	B._Gopal
Tunnel_of_Love_(album)	subsequentWork	Chimes_of_Freedom_(EP)
Brass_in_Pocket	album	Pretenders_(album)
Hampden_Sydney,_Virginia	isPartOf	Prince_Edward_County,_Virginia
Like_a_Star_in_the_Night	previousWork	Feel_Fine!
Queen_Kwong	associatedMusicalArtist	The_Icarus_Line
Navarre,_Florida	isPartOf	Santa_Rosa_County,_Florida
KENR	sisterStation	KGVO-FM
William_Flynn_(British_Army_soldier)	award	British_War_Medal
Dishoom	cinematography	Ayananka_Bose
Jimmy_McCulloch	associatedBand	One_in_a_Million_(band)
Five_Miles_Out_(song)	producer	Tom_Newman_(musician)
Fencing_at_the_1960_Summer_Olympics_–_Men's_team_foil	previousEvent	Fencing_at_the_1956_Summer_Olympics_–_Men's_team_foil
Lehigh_Line_(Conrail)	operatedBy	CSX_Transportation
Les_Filles_de_Caleb	starring	Pierre_Curzi
Street_Fighter_II′:_Champion_Edition	producer	Yoshiki_Okamoto
148th_Infantry_Regiment_(United_States)	militaryBranch	Ohio_Army_National_Guard
Mackenzie_River	mouthRegion	Inuvik_Region
William_Glasser	award	University_of_San_Francisco
Carnegie_(horse)	dam	Detroit_(horse)
Barry_Ditewig	team	Achilles_'29
Get_It_Done	guest	Lalaine
Lewis_County,_Tennessee	countySeat	Hohenwald,_Tennessee
Emmanuel_Dubourg	predecessor	Denis_Coderre
John_Lind_(politician)	successor	Loren_Fletcher
Paul_Atreides	child	Leto_II_Atreides
Nissan_Presea	relatedMeanOfTransportation	Nissan_Pulsar
Cristóbal_Vaca_de_Castro	birthPlace	Province_of_León
Pink_and_White_Productions	keyPerson	Pink_and_White_Productions
Queen_Kwong	associatedBand	The_Icarus_Line
Sridevi_Vijaykumar	parent	Manjula_Vijayakumar
Donga_Dongadi	director	Subramaniam_Siva
Dez_Fafara	associatedMusicalArtist	Coal_Chamber
Discouraged_Ones	recordedIn	Sunlight_Studio
Kibbie_Dome	location	Moscow,_Idaho
Petén_Department	isPartOf	Petén_Department
Elizabeth_(The_Statler_Brothers_song)	writer	Jimmy_Fortune
Peter_H._Hunt	occupation	Lighting_designer
Beatrice_Mintz	award	Genetics_Society_of_America_Medal
Miss_Me_(Mohombi_song)	previousWork	Bumpy_Ride
Causus_bilineatus	genus	Causinae
Interference_–_Book_Two	nonFictionSubject	Compassion_(Doctor_Who)
Hotlegs	formerBandMember	Kevin_Godley
Rupert_River	mouthMountain	Waskaganish
Sea_of_Dreams_(Misia_song)	subsequentWork	Any_Love_(Misia_song)
C._C._Young	governor	William_Stephens
Live_in_Dublin_(Leonard_Cohen_album)	recordedIn	3Arena
Rampage_(1963_film)	distributor	Seven_Arts_Productions
W._D._Smiles	successor	Patricia_Ford_(politician)
Revision3	owningCompany	Discovery_Digital_Networks
Assassin's_Creed_II	writer	Corey_May
Pagani_(automobile)	foundedBy	Horacio_Pagani_(auto_executive)
Santa_Rosa_County,_Florida	largestCity	Navarre,_Florida
The_Impassive_Footman	editing	Otto_Ludwig_(film_editor)
Lyubomir_Tsekov	team	FC_Sozopol
Breathless_(1960_film)	distributor	User-generated_content
Till_Death_Do_Us_Part_(NCIS)	guest	Scott_Wolf
Any_Love_(Misia_song)	previousWork	Sea_of_Dreams_(Misia_song)
Chitkara_University	affiliation	User-generated_content
Jiang_Wen	award	In_the_Heat_of_the_Sun
Müşfikâ_Kadınefendi	birthPlace	Caucasus
Hohenwald,_Tennessee	isPartOf	Lewis_County,_Tennessee
Richard_Waldron_(Colonel)	occupation	Councillor
Bob_Lanier_(politician)	birthPlace	Baytown,_Texas
KGVO-FM	sisterStation	KGVO_(AM)
Semir_Kerla	birthPlace	Rogatica
Cristian_Fatecha	team	Paraguay_men's_national_under-20_football_team
Shipmates_(film)	director	Harry_A._Pollard
Slug_(song)	artist	Original_Soundtracks_1
Owen_Madden_(footballer)	managerClub	Cork_Athletic_F.C.
Live_Tour_2013:_Japonesque	previousWork	Premium_Night:_Love_&_Songs
Alpena,_Arkansas	isPartOf	Boone_County,_Arkansas
The_Animal_Song	musicalArtist	Savage_Garden
Dupree,_South_Dakota	isPartOf	Ziebach_County,_South_Dakota
Fillmore_County,_Nebraska	largestCity	Geneva,_Nebraska
Slug_(song)	album	Original_Soundtracks_1
List_of_Tenchi_Muyo!_characters	voice	List_of_Tenchi_Muyo!_characters
The_Fratellis	bandMember	The_Fratellis
Leeland_(band)	hometown	Baytown,_Texas
Secrets_of_the_Castle	genre	Factual_television
KZMT	sisterStation	KBLL_(AM)
Ever_Changing_Times	recordLabel	GMA_Records
Go_for_Your_Guns	recordLabel	T-Neck_Records
Archery_at_the_2008_Summer_Olympics_–_Men's_team	nextEvent	Archery_at_the_2012_Summer_Olympics_–_Men's_team
Barry_Stout	region	Greene_County,_Pennsylvania
Sadhurangam_(1978_film)	writer	Visu
KHTS-FM	sisterStation	KOGO_(AM)
Shavkat_Mirziyoyev	birthPlace	Jizzakh_Region
X_X_(band)	associatedMusicalArtist	Rocket_from_the_Tombs
Richard_E._Miller	training	Jean-Paul_Laurens
Humana	industry	Managed_care
Mark-Paul_Gosselaar	education	William_S._Hart_High_School_(California)
Galien_River	rightTributary	Galien_River
Manjula_Vijayakumar	child	Sridevi_Vijaykumar
Sir_Henry_at_Rawlinson_End_(recording)	subsequentWork	Teddy_Boys_Don't_Knit
Kenny_Howes	associatedBand	Orange_Hat
Monkey_Businessmen	starring	Kenneth_MacDonald_(American_actor)
Guastalla	province	Province_of_Reggio_Emilia
Lake_Huron	part	Georgian_Bay
Valley_Bank_of_Kalispell	location	Kalispell,_Montana
Arizona_elegans_philipi	genus	Glossy_snake
Alex_Valentini	birthPlace	Guastalla
TPOK_Jazz	genre	Congolese_rumba
Wild_Cherries	formerBandMember	Wild_Cherries
Oru_Maravathoor_Kanavu	starring	Srinivas
Anthem_Inc.	industry	Managed_care
Three_Dark_Horses	starring	Kenneth_MacDonald_(American_actor)
Geneva,_Nebraska	isPartOf	Fillmore_County,_Nebraska
Aaron_Clapham	team	Dandenong_Thunder_SC
Jose_A._Velez,_Jr.	honours	Calder_Race_Course
Journey_to_the_Center_of_the_Earth	series	Voyages_extraordinaires
It's_Your_Thing	recordLabel	T-Neck_Records
What_I_Want_(Dead_or_Alive_song)	previousWork	Misty_Circles
2001–02_Everton_F.C._season	successor	2002–03_Everton_F.C._season
Barry_(album)	previousWork	One_Voice_(Barry_Manilow_album)
Joaquín_Camacho	successor	José_Miguel_Pey_de_Andrade
Harry_A._Pollard	birthPlace	Republic_County,_Kansas
The_Frontiersman	starring	Louise_Lorraine
St_Francis_Xavier's_College,_Liverpool	localAuthority	Liverpool_City_Council
Patrick_Hillery	taoiseach	Liam_Cosgrave
São_Tomé_and_Príncipe	leader	Manuel_Pinto_da_Costa
Faaa	mayor	Oscar_Temaru
Simaro_Lutumba	associatedBand	TPOK_Jazz
Glory_(Manafest_album)	producer	Manafest
KOGO_(AM)	sisterStation	KHTS-FM
Resurrection_in_Blood	artist	Runemagick
Kenny_Howes	associatedMusicalArtist	Orange_Hat
Neonism	recordedIn	Sunlight_Studio
Prince_Ludwig_August_of_Saxe-Coburg_and_Gotha	birthPlace	Eu,_Seine-Maritime
201st_Fighter_Squadron_(Mexico)	battle	Battle_of_Luzon
Holidays_in_the_Sun_(song)	previousWork	Pretty_Vacant
Lewis_County,_Tennessee	largestCity	Hohenwald,_Tennessee
Nelson_Cuevas	team	Paraguay_men's_national_under-20_football_team
KCAP_(defunct)	sisterStation	KZMT
Luge_at_the_1998_Winter_Olympics_–_Doubles	previousEvent	Luge_at_the_1994_Winter_Olympics_–_Doubles
Lady_Down_on_Love	album	The_Closer_You_Get...
Abdoulkader_Kamil_Mohamed	birthPlace	Obock_Region
Day_of_the_Diesels	narrator	Michael_Angelis
Susan_River_(California)	region	Lassen_County,_California
Alice:_Madness_Returns	developer	Spicy_Horse
Father_Brown_(2013_TV_series)	starring	Sorcha_Cusack
Jinxter	computingPlatform	Amstrad_PCW
Patricia_Ford_(politician)	predecessor	W._D._Smiles
Darling_River	leftTributary	Barwon_River_(New_South_Wales)
The_Pretender:_Island_of_the_Haunted	starring	Patrick_Bauchau
Silver_City_(2004_film)	writer	John_Sayles
201st_Fighter_Squadron_(Mexico)	garrison	Cozumel
Down_Under_the_Big_Top	starring	Phil_Joel
Salim_Ahamed	birthPlace	Kannur
Fuyumi_Ono	birthPlace	Nakatsu,_Ōita
Chasseurs_à_Cheval_de_la_Garde_Impériale	battle	Battle_of_Wagram
1st_The_Queen's_Dragoon_Guards	battle	2nd_Dragoon_Guards_(Queen's_Bays)
Dernier_Empereur	race	La_Coupe_de_Maisons-Laffitte
Men_with_Guns	writer	John_Sayles
Jasper_County,_Indiana	part	Rensselaer,_Indiana
W._D._Smiles	child	Patricia_Ford_(politician)
William_A._Stone	successor	William_Harrison_Graham
The_Hand_That_Rocks_the_Wheelchair	guest	Colin_Ford
José_Montiel	team	Paraguay_men's_national_under-20_football_team
Juan_Hernández_López	region	Puerto_Rico_Senatorial_district_I
French_River_(Ontario)	riverMouth	Georgian_Bay
Any_Trouble	bandMember	Mark_Griffiths
Manic_Monday	subsequentWork	If_She_Knew_What_She_Wants
Gary_Fenlon	successor	Ted_Radke
2014_British_Grand_Prix	thirdDriver	Daniel_Ricciardo
Mount_Carmel_High_School_(Chicago)	authority	Roman_Catholic_Archdiocese_of_Chicago
Hever_Castle	type	Castle
Overkill_(Men_at_Work_song)	writer	Colin_Hay
I_Know_Things_Now	guest	Jim_O'Heir
John_George_I,_Duke_of_Saxe-Eisenach	successor	John_George_II,_Duke_of_Saxe-Eisenach
X_X_(band)	associatedBand	Rocket_from_the_Tombs
Oscar_Temaru	birthPlace	Faaa
I_Think_My_Older_Brother_Used_to_Listen_to_Lagwagon	producer	Jamie_McMann
Delaware_River_Iron_Ship_Building_and_Engine_Works	foundedBy	John_Roach_(shipbuilder)
Darling_River	source	Barwon_River_(New_South_Wales)
Face_of_Fact	musicalBand	Kotoko_(musician)
Grand_Teton_National_Park	location	Teton_County,_Wyoming
The_Possum	guest	Jim_O'Heir
Kent_Conrad	successor	Pete_Domenici
Scattered_(The_Kinks_song)	previousWork	Only_a_Dream
Bonnybridge	lieutenancyArea	Stirling_and_Falkirk
Baboon	family	Papionini
Lou_Sagastume	team	San_Antonio_Thunder
KEPN	owner	Bonneville_International
Durgapur	governmentType	Durgapur
Workbench_Songs	subsequentWork	Americana_Master_Series:_Best_of_the_Sugar_Hill_Years
The_Whalers	director	Dick_Huemer
KGVO-FM	sisterStation	KENR
The_Professional_Secrets_of_Dr._Apfelgluck	starring	Jean_Yanne
Novellara	province	Province_of_Reggio_Emilia
John_Linder	region	Georgia's_7th_congressional_district
Cinder_Block_(musician)	recordLabel	Rodent_Popsicle_Records
Get_It_Done	guest	Indigo_(actress)
Jamie_Robinson_(rugby_player)	formerTeam	Cardiff_Blues
Rupert_River	mouthPlace	Waskaganish
Drive_Like_Jehu	associatedMusicalArtist	Obits
The_Proud_Family_Movie	producer	Bruce_W._Smith
Circus_(TV_series)	starring	Renuka_Shahane
The_Thorns_of_Life	associatedMusicalArtist	Crimpshrine
Mackenzie_River	city	Wrigley,_Northwest_Territories
Joe_Stillman	notableWork	Shrek
Miguel_Trovoada	president	Manuel_Pinto_da_Costa
Not_This_Year	writer	AJ_Michalka
Pink_and_White_Productions	foundedBy	Pink_and_White_Productions
Brideshead_Revisited_(film)	starring	Ben_Whishaw
Ian_Shepherd	associatedBand	Royal_Philharmonic_Orchestra
Why_Don't_You_&_I	album	Shaman_(album)
Glossy_snake	genus	Glossy_snake
Blood_on_My_Hands	recordedIn	2008_in_music
Blind_Spot_(Homeland)	guest	Sarita_Choudhury
Rocket_from_the_Tombs	associatedMusicalArtist	The_Dead_Boys
WIOD	broadcastNetwork	AccuWeather
Denis_Coderre	successor	Emmanuel_Dubourg
Boy_Next_Door_(song)	musicalBand	Jamelia
John_S._Mason	relation	Lucretia_Garfield
2003–04_Millwall_F.C._season	position	2003–04_Football_League
Francis_of_Paola	birthPlace	Province_of_Cosenza
Dynamos_F.C._(South_Africa)	manager	Owen_Da_Gama
'Cause_I'm_a_Man	recordedIn	Fremantle
Kourou,_French_Guiana	arrondissement	Cayenne
Assassin's_Creed_(video_game)	writer	Corey_May
Bob_Nash_(American_football)	deathPlace	Winchester,_Connecticut
Game_Plan_(TV_series)	starring	Tong_Bing_Yu
Phascogalini	order	Dasyuromorphia
Hidden_Kingdoms	genre	Factual_television
Vagabond_Loafers	starring	Kenneth_MacDonald_(American_actor)
Fleurety	recordLabel	Misanthropy_Records
Abra_River	rightTributary	Abra_River
Silvestre_Igoa	team	Catarroja_CF
Escape_to_France	starring	Folco_Lulli
Shooting_at_the_1912_Summer_Olympics_–_Men's_25_metre_team_small-bore_rifle	goldMedalist	Vilhelm_Carlberg
Venkatraman_Ramakrishnan	birthPlace	Chidambaram
A_Quantum_Murder	publisher	Pan_Books
Leto_II_Atreides	relative	Paul_Atreides
Ramón_H._Dovalina	almaMater	Martin_High_School_(Laredo,_Texas)
Little_Nicky	writer	Steven_Brill_(scriptwriter)
Indochine_(film)	starring	Jean_Yanne
Rigoberta_Menchú	award	Princess_of_Asturias_Awards
Margarita_Fischer	spouse	Harry_A._Pollard
S.O.S._Tidal_Wave	producer	Armand_Schaefer
Small-eared_shrew	family	Shrew
Riley_Baugus	hometown	Walkertown,_North_Carolina
Mixels	voice	Mixels
To_See_the_Invisible_Man	subsequentWork	Tooth_and_Consequences
Roman_Catholic_Diocese_of_Gaylord	territory	Cheboygan_County,_Michigan
Charles_Robert_Sherman	child	Charles_Taylor_Sherman
John_Lind_(politician)	successor	Samuel_Rinnah_Van_Sant
Peter_Furler_Band	formerBandMember	Phil_Joel
Streets_of_Bakersfield	album	Buenas_Noches_from_a_Lonely_Room
Jackpot_(1993_film)	starring	Manjula_Vijayakumar
Francis_Julius_LeMoyne	deathPlace	Washington,_Pennsylvania
Helmsley	district	Ryedale
Kasserine	isPartOf	Kasserine_Governorate
1997–98_Derby_County_F.C._season	homeStadium	Pride_Park_Stadium
Congolese_rumba	musicFusionGenre	Mbalax
Salt_Fork_Arkansas_River	mouthMountain	Kay_County,_Oklahoma
Shooting_at_the_1912_Summer_Olympics_–_Men's_50_metre_team_free_pistol	silverMedalist	Vilhelm_Carlberg
Iliyan_Kapitanov	team	FC_Sozopol
Juan_Temístocles_Montás	almaMater	Technical_University_of_Madrid
Jose_Pablo_Cantillo	birthPlace	Marshfield,_Wisconsin
Locomotive_Games	predecessor	Locomotive_Games
Tubular_Bells_II	producer	Tom_Newman_(musician)
Phaeoramularia	order	Capnodiales
Merzbow	recordLabel	Alchemy_Records_(Japan)
Illizi	isPartOf	Illizi
Orthophonic_Joy	artist	Steep_Canyon_Rangers
Assassin's_Creed_(video_game)	producer	Jade_Raymond
Roman_Catholic_Diocese_of_Gaylord	territory	Ogemaw_County,_Michigan
Canciones_Prohibidas	artist	Extremoduro
The_Twelve_Kingdoms	author	Fuyumi_Ono
Jeff_Wassmann	field	Assemblage_(art)
Jack_Perrin	birthPlace	Three_Rivers,_Michigan
Mànran	bandMember	Ewen_Henderson_(musician)
Paola,_Calabria	saint	Francis_of_Paola
J._T._Dorsey	team	Loyola_Greyhounds_men's_soccer
The_Winter_Album_(NSYNC_album)	producer	Johnny_Wright_(music_manager)
The_History_Mix_Volume_1	producer	Kevin_Godley
Dream_On_(Nazareth_song)	writer	Dan_McCafferty
The_Hummingbirds	formerBandMember	The_Hummingbirds
Wedding_Bell_Blues_(film)	starring	John_Corbett
Elmer_Ernest_Southard	field	Neuropsychiatry
Pete_T._Cenarrusa	birthPlace	Carey,_Idaho
Ocypodidae	family	Ocypodoidea
Les_Amants_du_Pont-Neuf	starring	Édith_Scob
São_Jorge_Castle	type	Castle
Air_Canada	hubAirport	Toronto_Pearson_International_Airport
The_Dress_Rehearsal	director	Mimi_Leder
Christos_Melissis	team	Naoussa_F.C.
Gelao_language	spokenIn	Wenshan_Zhuang_and_Miao_Autonomous_Prefecture
Secrets_(1992_American_film)	director	Peter_H._Hunt
2015_Carolina_RailHawks_season	season	2015_in_American_soccer
Siege_of_Petropavlovsk	place	Petropavlovsk-Kamchatsky
2015–16_Aberdeen_F.C._season	league	2015–16_Scottish_Premiership
Shorty_(band)	recordLabel	Skin_Graft_Records
Julien_Laharrague	formerTeam	SU_Agen_Lot-et-Garonne
Arthur_MacArthur_III	battle	Battle_of_Santiago_de_Cuba
Assassin's_Creed:_Brotherhood	writer	Corey_May
Queer_as_Folk_(UK_TV_series)	executiveProducer	Nicola_Shindler
Oru_Maravathoor_Kanavu	producer	Kokers_Films
Chima_Okorie	birthPlace	Abia_(state)
After_Love_(film)	editing	Christian_Gaudin_(editor)
Shanghai'd_in_Shanghai	writer	Dan_McCafferty
William_Harrison_Graham	region	Pennsylvania's_23rd_congressional_district
Udaari	starring	Samiya_Mumtaz
When_the_Dead_Come_Knocking	guest	Jose_Pablo_Cantillo
Muskurahat_(1992_film)	starring	Jagdeep
High_Level	isPartOf	Mackenzie_County
Vallinam	starring	Atul_Kulkarni
WNBW-DT	sisterStation	WYME-CD
Massachusetts_Route_27	routeEnd	Chelmsford,_Massachusetts
Pretty_Handsome_Awkward	subsequentWork	Blood_on_My_Hands
José_Miguel_Pey_de_Andrade	deathPlace	Cundinamarca_Department_(1824)
Static,_Kentucky_and_Tennessee	isPartOf	Clinton_County,_Kentucky
Leatherface:_The_Texas_Chainsaw_Massacre_III	starring	William_Butler_(actor)
KEYE-TV	sisterStation	KFOX-TV
U.S._Route_18_in_Iowa	routeJunction	Sheldon,_Iowa
Serge_Honi	team	Naoussa_F.C.
Allan_Egolf	region	Perry_County,_Pennsylvania
Get_It_Done	previousWork	First_Date_(Buffy_the_Vampire_Slayer)
Lawrence,_New_Zealand	isPartOf	Clutha_District
Chiping_County	isPartOf	Liaocheng
San_Francisquito_Creek	rightTributary	Corte_Madera_Creek_(San_Mateo_County,_California)
River_Roch	district	Littleborough,_Greater_Manchester
Office_Girls	channel	TTV_Main_Channel
Here,_Under_Protest	producer	Jamie_McMann
Galusha_A._Grow	successor	Pennsylvania's_30th_congressional_district
Leopold_Vietoris	doctoralAdvisor	Gustav_von_Escherich
Franklin_Lawson	team	Carolina_Lightnin'
Wyndham_Deedes	occupation	Councillor
Orange-billed_lorikeet	binomialAuthority	Ernst_Hartert
OSS_117:_Lost_in_Rio	producer	Éric_and_Nicolas_Altmayer
