Dream_(Japanese_group)	bandMember	Dream_(Japanese_group)
Nordman	bandMember	Nordman
Darren_Stewart	managerClub	Gombak_United_FC
The_Anonymous_Heroes	musicComposer	Frankie_Chan
The_Scarecrow_(1920_film)	starring	Joe_Keaton
Alien_Bodies	subsequentWork	Kursaal_(novel)
Daniel_Vorländer	birthPlace	Eupen
WICO-FM	sisterStation	WICO_(AM)
Enver_Hoxhaj	almaMater	University_of_Pristina_(1969–99)
William_C._Martel	deathPlace	Bedford,_New_Hampshire
Sultandağı	isPartOf	Afyonkarahisar_Province
Caroline_Cellier	spouse	Jean_Poiret
Trying_to_Stop_Your_Leaving	subsequentWork	Feel_That_Fire_(song)
Galician_Movement_for_Socialism	ideology	Galician_independence
Más_allá_del_puente	creator	René_Muñoz
Paul_Calandra	predecessor	Dean_Del_Mastro
Sırrı_Süreyya_Önder	region	Ankara_(electoral_districts)
Isuzu_(Anadolu)	product	Minibus
California_Gold_Rush_(film)	editing	Charles_Craft
Driscoll's	product	Raspberry
Pete_Mead	birthPlace	Trumann,_Arkansas
The_Page_from_the_Dalmasse_Hotel_(1933_film)	producer	Robert_Wuellner
Arunagirinathar_(film)	starring	C._Lakshmi_Rajyam
Angel_Baby_(1995_film)	starring	Deborra-Lee_Furness
Daniel_Pinkwater	notableWork	Daniel_Pinkwater
Camel	family	Camelini
Marshall_Formby	region	Lamb_County,_Texas
Mark_Beeney	birthPlace	Pembury
Shake,_Rattle_&_Roll_IV	starring	Gina_Alajar
Tomb_Raider_(2013_video_game)	series	Tomb_Raider
Distant_Lights_(2003_film)	starring	August_Diehl
Historias_de_la_radio	writer	José_Luis_Sáenz_de_Heredia
Brazilian_Army	notableCommander	Manuel_Luís_Osório,_Marquis_of_Erval
The_Longest_Yard_(2005_film)	director	Peter_Segal
Illinois_Route_59	routeJunction	Plainfield,_Illinois
Castelvetrano	province	Province_of_Trapani
Take_These_Chains_from_My_Heart	album	On_the_Road_(Lee_Roy_Parnell_album)
Albaida,_Valencia	isPartOf	Vall_d'Albaida
G.B.H._(TV_series)	starring	Robert_Lindsay_(actor)
J._R._Simplot	education	Eighth_grade
The_Nine_Lives_of_Chloe_King	starring	Amy_Pietz
This_Is_England_'86	starring	Thomas_Turgoose
Philip_William,_Prince_of_Orange	deathPlace	Southern_Netherlands
Sheila_E._(album)	previousWork	Romance_1600
Francisco_Antonio_Pinto	predecessor	Ramón_Freire
Alex_Ferrari_(singer)	birthPlace	Rondônia
Atlético_Choloma	league	Liga_Nacional_de_Ascenso_de_Honduras
Wild_Bill_Hickok_(film)	starring	James_Farley_(actor)
Peneda-Gerês_National_Park	region	Alto_Trás-os-Montes
Eight_Second_Ride	album	Easy_Does_It_(Jake_Owen_album)
Yesterday's_Men	recordLabel	Zarjazz
I_Love_Money_(season_4)	previousWork	I_Love_New_York_2
Whiting_Brothers	locationCity	St._Johns,_Arizona
Craig_Duby	party	Craig_Duby
Muni_(film)	starring	Vedhika
Apocryptes_bato	genus	Apocryptes_bato
Robin_Lee_Bruce	associatedMusicalArtist	Alannah_Myles
Korhogo_Department	isPartOf	Savanes_District
Hello_Saferide	bandMember	Annika_Norlin
Bolsas_y_Mercados_Españoles	service	Fixed_income
Chrysopelea_ornata	genus	Chrysopelea
Ehsan_Danish	notableWork	Ehsan_Danish
U.S._Route_64_in_North_Carolina	routeJunction	Williamston,_North_Carolina
So_I_Married_an_Axe_Murderer	producer	Robert_N._Fried
Noli_me_tangere_(novel)	author	José_Rizal
2012–13_Real_Betis_season	ground	Estadio_Benito_Villamarín
Where_the_Streets_Have_No_Name	album	The_Joshua_Tree
Coty,_Inc.	product	Aroma_compound
Waar	writer	Hassan_Rana
Alberto_Madruga_da_Costa	birthPlace	Matriz_(Horta)
A_Kitty_Bobo_Show	voice	Dante_Basco
Corrado_Tommasi-Crudeli	influenced	Ettore_Marchiafava
Romance_1600	subsequentWork	Sheila_E._(album)
Road_Blaster	developer	Victor_Interactive_Software
Kursaal_(novel)	previousWork	Alien_Bodies
Sanjay_Tandon	education	Chartered_accountant
Moonshell_(horse)	damsire	Kris_(horse)
Margherita_Buy	award	Manual_of_Love
Bob_Bates	employer	Bob_Bates
Ministry_of_Defense_(Venezuela)	leader	Vladimir_Padrino_López
TV3_(Catalonia)	owningCompany	Televisió_de_Catalunya
Guru_Amar_Das	predecessor	Guru_Angad
Historias_de_la_radio	director	José_Luis_Sáenz_de_Heredia
Painters_and_Dockers	formerBandMember	Painters_and_Dockers
U.S._Route_360	routeJunction	Burkeville,_Virginia
Slaton,_Texas	isPartOf	Llano_Estacado
The_Perfect_Holiday	distributor	Yari_Film_Group
We_Don't_Even_Live_Here	producer	Cecil_Otter
Miracle_at_St._Anna	editing	Barry_Alexander_Brown
Redefinition_(song)	subsequentWork	Love_Is_All...
The_Butler_Did_It_(A_Bird_in_the_Hand)	director	Georg_Stanford_Brown
Truly_Yours_(The_Spinners_song)	producer	Ivy_Jo_Hunter
Lumières_Award	presenter	Lumières_Award
KBID-LP	owningCompany	Cocola_Broadcasting
Yosemite_Valley	architect	Frederick_Law_Olmsted
Çoruh_River	riverMouth	Black_Sea
George_Earth	associatedMusicalArtist	World_Entertainment_War
Frank_Worth_Elliott,_Jr.	birthPlace	Statesville,_North_Carolina
KDCG-CD	formerBroadcastNetwork	America_One
Petone_Workshops	predecessor	Petone_Workshops
Losing_Isaiah	producer	Hawk_Koch
Freedom_and_Justice_Party_(Egypt)	nationalAffiliation	Anti-Coup_Alliance
Black_and_White_America	recordedIn	Eleuthera
You're_the_Greatest,_Charlie_Brown	creator	Charles_M._Schulz
Feel_That_Fire_(song)	previousWork	Trying_to_Stop_Your_Leaving
Jeff_Davis_(writer)	birthPlace	Milford,_Connecticut
David_Stone_(politician)	successor	Benjamin_Smith_(North_Carolina_politician)
Konza_Prairie	animal	American_bison
Family_Law_(film)	producer	Diego_Dubcovsky
A_Brighter_Beat_(album)	artist	Malcolm_Middleton
Roman_Catholic_Archdiocese_of_Mechelen-Brussels	province	Roman_Catholic_Archdiocese_of_Mechelen-Brussels
23rd_Brigade_(Australia)	notableCommander	Arnold_Potts
Roman_Catholic_Diocese_of_Ardagh_and_Clonmacnoise	province	Roman_Catholic_Archdiocese_of_Armagh
That_Still_Small_Voice	guest	Carolyn_Hennesy
List_of_Disney's_The_Little_Mermaid_characters	voice	Christopher_Daniel_Barnes
Scotched_in_Scotland	cinematography	Ray_Cory
Mean_(song)	previousWork	Back_to_December
The_Shield_and_the_Sword	album	Light_After_Dark
London_Breed	predecessor	Katy_Tang
E._Roland_Harriman	relative	Mary_Harriman_Rumsey
Robert_W._Welch,_Jr.	birthPlace	Chowan_County,_North_Carolina
Pilot_(Body_of_Proof)	director	Nelson_McCormick_(director)
Derek_Edwardson	birthPlace	Morton_Grove,_Illinois
Razorlight_(album)	recordedIn	British_Grove_Studios
Love_Is_All...	previousWork	Redefinition_(song)
Mahendra_of_Nepal	parent	Queen_Kanti_of_Nepal
Thomas_Tuchel	managerClub	FC_Augsburg_II
Gift_Muzadzi	team	Mighty_Wanderers_F.C.
She's_a_Windup	album	Be_Seeing_You
Wide_Awake_in_America	subsequentWork	The_Joshua_Tree
The_Dirtbombs	bandMember	The_Dirtbombs
Congorama	starring	Gabriel_Arcand
Hanergy	subsidiary	Hanergy
Abukuma_Express_Line	location	Tōhoku_region
X-Ray_Vision_(song)	musicalArtist	TKA
Happy_Song	album	Kalimba_de_Luna_–_16_Happy_Songs
Căile_Ferate_Române_Line_900	type	Passenger
Malaysia_Federal_Route_11	routeStart	Negeri_Sembilan
Abbott's_crested_lizard	binomialAuthority	Doris_Mable_Cochran
David_Davis_(handballer)	club	BM_Neptuno
National_Congress_of_Honduras	politicalPartyInLegislature	Liberty_and_Refoundation
Conquest_of_Cheyenne	editing	Charles_Craft
Paul_A._Porter	almaMater	University_of_Kentucky_College_of_Law
WBNQ	sisterStation	WJBC-FM
Battle_of_Kashgar_(1933)	commander	Ma_Zhancang
Myron_J._Gordon	award	Ford_Foundation
Sahara_(1943_film)	writer	Philip_MacDonald
Truly_Yours_(The_Spinners_song)	writer	Ivy_Jo_Hunter
The_Adicts	recordLabel	DC-Jam_Records
Agnes_of_Germany	parent	Henry_IV,_Holy_Roman_Emperor
Nomorhamphus	order	Beloniformes
The_Original_Kings_of_Comedy	editing	Barry_Alexander_Brown
Marie_of_Burgundy,_Duchess_of_Cleves	parent	Margaret_of_Bavaria
Them_(TV_series)	starring	Reg_Rogers
Tahqiqaat	director	A._Jagannathan
Peacock_(2010_film)	producer	Barry_Mendel
Fur_and_Gold	recordLabel	Manimal_Vinyl
Russ_Feingold	residence	Middleton,_Wisconsin
Juan_Raudales	team	Atlético_Choloma
Jan-Ingwer_Callsen-Bracker	team	FC_Augsburg_II
Cairo_(1963_film)	producer	Ronald_Kinnoch
Maxillary_nerve	branchTo	Maxillary_nerve
Peter_I,_Count_of_Urgell	deathPlace	Crown_of_Aragon
Orkhon_River	state	Övörkhangai_Province
The_11th_Hour_(video_game)	composer	George_Sanger_(musician)
Étoile_Filante_du_Togo	league	Togolese_Championnat_National
Absolute_Darling	subsequentWork	Once_Upon_a_Love
O_Jerusalem_(novel)	author	Laurie_R._King
Home_of_the_Gentry	literaryGenre	Political_fiction
Andrew_Mitchell	almaMater	Jesus_College,_Cambridge
Frederick_VI_of_Denmark	predecessor	Christian_VII_of_Denmark
The_Fighting_Fitzgeralds	starring	Christopher_Moynihan
WVSL_(AM)	city	Selinsgrove,_Pennsylvania
Take_a_Look_(song)	subsequentWork	Tracie_(song)
Henry_Danger	company	Schneider's_Bakery
Yves_A._Lussier	academicAdvisor	Carol_Friedman
South_African_Party	ideology	White_nationalism
Petone_Workshops	parentCompany	New_Zealand_Railways_Department
1990–91_A.S._Roma_season	manager	Ottavio_Bianchi
Newsround	related	Newsround
World_Entertainment_War	formerBandMember	George_Earth
Mauregard_(mini_series)	author	Claude_de_Givray
Goniatitinae	order	Goniatitina
Robin_Lee_Bruce	associatedBand	Alannah_Myles
Sunnyside_(film)	distributor	Entertainment_One_Films_US
Slinger,_Wisconsin	isPartOf	Washington_County,_Wisconsin
Sorry_for_Party_Rocking_(song)	producer	Redfoo
Ghost_Town_(Adam_Lambert_song)	writer	Tobias_Karlsson_(songwriter)
Mahilpur	isPartOf	Hoshiarpur_district
Leo_Auva'a	formerTeam	Leinster_Rugby
Canute_VI_of_Denmark	parent	Sophia_of_Minsk
The_7.39	author	David_Nicholls_(writer)
I_Found_Out_(The_Pigeon_Detectives_song)	album	Wait_for_Me_(The_Pigeon_Detectives_album)
Joseph_Addabbo,_Jr.	almaMater	St._John's_University_(New_York_City)
Borough_of_Waverley	leaderName	Jeremy_Hunt
Rayman_Legends	developer	Ubisoft_Montpellier
Ramón_Freire	successor	Francisco_Antonio_Pinto
Vall_d'Albaida	part	Albaida,_Valencia
Margaret_I,_Countess_of_Flanders	parent	Sibylla_of_Anjou
Harry_Osman	birthPlace	Bentworth
X-Ray_Vision_(song)	musicalBand	TKA
Jack_Johnson_and_Friends_–_Best_of_Kokua_Festival	recordedIn	Jack_Johnson_and_Friends_–_Best_of_Kokua_Festival
E_311_road_(United_Arab_Emirates)	routeJunction	E_44_road_(United_Arab_Emirates)
The_First_Big_Weekend	writer	Malcolm_Middleton
Kesang_Choden_(born_1930)	spouse	Jigme_Dorji_Wangchuck
Peter_I,_Count_of_Urgell	successor	James_I_of_Aragon
Tucker_Max	notableWork	Tucker_Max
WICO_(AM)	sisterStation	WICO-FM
Vladimir_Bubnov	managerClub	FC_Volga-d_Ulyanovsk
Mothertime	starring	Faith_Brook
Mr._Garrity_and_the_Graves	subsequentWork	The_Brain_Center_at_Whipple's
Billy_Laughlin	birthPlace	San_Gabriel,_California
The_Adventures_of_Sharkboy_and_Lavagirl_in_3-D	starring	The_Adventures_of_Sharkboy_and_Lavagirl_in_3-D
KSVT-LD	location	Twin_Falls,_Idaho
Guru_Angad	successor	Guru_Amar_Das
Once_Upon_a_Time_(1944_film)	writer	Lucille_Fletcher
Muhammad_Dahlan_(Minister)	birthPlace	Pasuruan
Dell_Rapids,_South_Dakota	isPartOf	Minnehaha_County,_South_Dakota
2006–07_Hibernian_F.C._season	chairman	Rod_Petrie
Norbert_Nachtweih	team	East_Germany_national_under-21_football_team
Mest	formerBandMember	Mest
Guidobaldo_II_della_Rovere,_Duke_of_Urbino	birthPlace	Urbino
Tracie_(song)	previousWork	Take_a_Look_(song)
Henry_Bates_Grubb	relative	Curtis_Grubb
Tintri	industry	Virtualization
List_of_Bengaluru_FC_players	currentMember	Sunil_Chhetri
Arima_Nambi	distributor	Vendhar_Movies
Lauria	frazioni	Lauria
Wilmer_X	bandMember	Wilmer_X
Disney's_Party	developer	Jupiter_(company)
Halinga_Parish	isPartOf	Pärnu_County
Kris_Bright	birthPlace	Manukau_City
Hydlide	publisher	Fujisankei_Communications_International
8th_Battalion_(Australia)	commandStructure	23rd_Brigade_(Australia)
Live_in_Paris_&_Ottawa_1968	recordLabel	Dagger_Records
Dirty_Work_(1998_film)	director	Bob_Saget
Merlucciidae	order	Gadiformes
Damjan_Blečić	club	RK_Partizan
Immortal_Megamix	subsequentWork	I_Just_Can't_Stop_Loving_You
Toxi	editing	Alice_Ludwig
Patrice_Chéreau	occupation	List_of_opera_directors
Men_Are_Such_Fools_(1932_film)	writer	Viola_Brothers_Shore
Helicobacter	order	Campylobacterales
METRORail	operatedBy	Metropolitan_Transit_Authority_of_Harris_County
Captain_China	starring	Michael_O'Shea_(actor)
Sooraj_Dooba_Hain	musicalArtist	Arijit_Singh
The_Raistlin_Chronicles	previousWork	The_Raistlin_Chronicles
Myxodagnus	family	Sand_stargazer
Mechado	ingredient	Tomato_sauce
David_Salle	movement	Contemporary_art
Clem_Hawke	child	Clem_Hawke
Chiojdul_River_(Bâsca_Chiojdului)	riverMouth	Bâsca_Chiojdului_River
Wyndham_Hotels_&_Resorts	location	Parsippany-Troy_Hills,_New_Jersey
Drava	city	Lienz
Laurie_Halse_Anderson	notableWork	Laurie_Halse_Anderson
Heimkehr	starring	Attila_Hörbiger
Live_(Donny_Hathaway_album)	previousWork	Donny_Hathaway_(album)
Tony_Hand	team	Manchester_Phoenix
Managra	series	Virgin_Missing_Adventures
Mauregard_(mini_series)	director	Claude_de_Givray
Jazz_(We've_Got)	previousWork	Check_the_Rhime
Thermoplasmatales	class	Thermoplasmata
Felitciano_Zschusschen	team	VV_Baronie
Riot!	subsequentWork	Live_in_the_UK_2008
Mike_Quigley_(politician)	almaMater	Loyola_University_Chicago_School_of_Law
The_Inside_Story_(film)	starring	Florence_Bates
James_Knepper	successor	Harris_Wofford
Laurie_Halse_Anderson	genre	Picture_book
Sooraj_Dooba_Hain	musicalBand	Arijit_Singh
International_Durastar	class	Truck_classification
Wolfson_Microelectronics	keyPerson	Chief_commercial_officer
The_Raistlin_Chronicles	subsequentWork	The_Raistlin_Chronicles
Frederick_VI_of_Denmark	parent	Christian_VII_of_Denmark
Telecommunication_(song)	writer	Paul_Reynolds_(musician)
Erpobdelliformes	order	Arhynchobdellida
Silver_Line_(Washington_Metro)	isPartOf	Washington_Metro
Piedmont,_Alabama	isPartOf	Cherokee_County,_Alabama
Brooklyn_Without_Limits	director	Michael_Engler
A_Love_Bizarre	album	Romance_1600
The_Nap	guest	Richard_Herd
Sacachispas	league	Primera_División_de_Ascenso
Live_in_the_UK_2008	previousWork	Riot!
Once_Upon_a_Love	previousWork	Absolute_Darling
Christian_VII_of_Denmark	successor	Frederick_VI_of_Denmark
Phillip_Gyau	team	Washington_Warthogs
Flemish_Community	leaderName	Flemish_Government
Lilya_4-ever	distributor	Sonet_Film
Edmond_Locard	knownFor	Sherlock_Holmes
Fishers_Island,_New_York	isPartOf	Southold_(town),_New_York
Greentown,_Indiana	isPartOf	Howard_County,_Indiana
X-COM:_Terror_from_the_Deep	gameEngine	UFO:_Enemy_Unknown
Presidio_Med	director	Nelson_McCormick_(director)
George_Earth	associatedBand	World_Entertainment_War
Oka_River	city	Dzerzhinsk,_Russia
The_Lord_of_the_Rings_(film_series)	writer	Philippa_Boyens
Walther_Bronsart_von_Schellendorff	battle	Second_Schleswig_War
The_Garfield_Show	distributor	Dargaud
Dexter_Langen	team	VfB_Gießen
E_44_road_(United_Arab_Emirates)	routeJunction	E_311_road_(United_Arab_Emirates)
Jake_Dancy	team	Fresno_State_Bulldogs
Plotinus	influenced	John_Scotus_Eriugena
Eduardo_Conget	team	CD_Izarra
The_Van_Dyke_Show	director	Jay_Sandrich
John_Sergeant_(journalist)	education	Bloxham_School
Koi_Tujh_Sa_Kahaan	starring	Nadeem_Baig_(actor)
FAUR	foundedBy	Nicolae_Malaxa
Detachment_(film)	editing	Barry_Alexander_Brown
Anybody's_Woman	writer	Zoë_Akins
Harjit_Sajjan	birthPlace	Hoshiarpur_district
John_R._Napier	notableStudent	Alison_Richard
John_B._McNair	successor	Hugh_John_Flemming
Salvation_(The_Cranberries_song)	previousWork	Ridiculous_Thoughts
Forty_Winks_(film)	starring	Anna_May_Wong
Space_Battleship_Yamato_(2010_film)	starring	Toshiyuki_Nishida
Deathstalker_War	author	Simon_R._Green
1987_Munster_Senior_Hurling_Championship_Final	team	Tipperary_GAA
Ma_Zhancang	battle	Battle_of_Kashgar_(1933)
Cairo_(1963_film)	starring	John_Meillon
Last_Time_(Trey_Songz_song)	producer	Kendrick_Dean
Three_Mile_Pilot	bandMember	Three_Mile_Pilot
Ellis_Samuel_Ato	team	Kaposvölgye_VSC
19th_Light_Dragoons	battle	Siege_of_Seringapatam_(1799)
Cisticola	family	Cisticolidae
Blue_Sky_(film)	starring	Amy_Locane
Humongous_Entertainment	location	Industry,_California
Pape_Samba_Ba	team	MKP_Pogoń_Siedlce
Hugh_John_Flemming	successor	Louis_Robichaud
I_Will_Not_Bow	album	Dear_Agony
Queen_Bee_(film)	starring	Betsy_Palmer
Cross-country_skiing_at_the_2010_Winter_Olympics_–_Men's_4_×_10_kilometre_relay	goldMedalist	Johan_Olsson_(skier)
Submarine_(2010_film)	starring	Craig_Roberts
All_Tomorrow's_Parties	subsequentWork	Sunday_Morning_(The_Velvet_Underground_song)
The_Sea_of_Trees	starring	Ken_Watanabe
Ruth_Johnson	birthPlace	Holly,_Michigan
Art_for_Art's_Sake_(song)	album	How_Dare_You!_(album)
Snigdha_Pandey	knownFor	Navya..Naye_Dhadkan_Naye_Sawaal
European_bullhead	family	Cottidae
28th_Battalion_(Australia)	commandStructure	5th_Division_(Australia)
KQXY-FM	sisterStation	KQXY-FM
2014_Orlando_City_SC_season	league	2014_USL_Pro_season
1968_Mexican_Grand_Prix	location	Autódromo_Hermanos_Rodríguez
Xichang	isPartOf	Liangshan_Yi_Autonomous_Prefecture
Boston_Scientific	industry	Medical_equipment
KFTL-CD	owningCompany	LocusPoint_Networks
Kevin_Scott_(footballer)	team	Middlesbrough_F.C._Reserves_and_Academy
Agu_Casmir	team	Gombak_United_FC
Brule,_Wisconsin	isPartOf	Douglas_County,_Wisconsin
Cédric_Daury	birthPlace	Meudon
John_Denver_and_the_Muppets:_A_Christmas_Together	producer	Bob_Finkel
2012–13_Real_Betis_season	homeStadium	Estadio_Benito_Villamarín
Aleksandar_Aleksandrov_(footballer,_born_1975)	team	FC_Maritsa_Plovdiv
John_Lignos	birthPlace	Chios
IParty_with_Victorious	musicComposer	IParty_with_Victorious
David_Gulpilil	birthPlace	Arnhem_Land
2003_Kyoto_Purple_Sanga_season	manager	Gert_Engels
Farfantepenaeus	order	Dendrobranchiata
The_Cabin_in_the_Cotton	writer	Paul_Green_(playwright)
Oversea-Chinese_Banking_Corporation	subsidiary	Oversea-Chinese_Banking_Corporation
Persona_5	genre	Social_simulation_game
The_Flowers_of_War	producer	William_Kong
Adam_Martin_Wyant	region	Pennsylvania's_22nd_congressional_district
Eighteen_Springs_(film)	producer	Jimmy_Wang_Yu
Vigilante_Hideout	writer	Richard_Wormser
Antipop	previousWork	Rhinoplasty_(EP)
Cal_FC	league	United_States_Adult_Soccer_Association
Otto_III,_Holy_Roman_Emperor	deathPlace	Civita_Castellana
Tito_and_Me	starring	Miki_Manojlović
Blame_(Collective_Soul_song)	album	Disciplined_Breakdown
Simisola	publisher	Crown_Publishing_Group
U.P.O.	formerBandMember	U.P.O.
Aspergillus	order	Eurotiales
Just_in_Singapore	starring	Chen_Liping
Sagadat_Nurmagambetov	birthPlace	Akmola_Region
Joseph_Pulitzer	region	New_York's_9th_congressional_district
1995–96_Portsmouth_F.C._season	predecessor	1994–95_Portsmouth_F.C._season
WOPI-CD	formerBroadcastNetwork	America_One
Hoplocercidae	family	Iguanidae
Vítor_Gaspar	primeMinister	Pedro_Passos_Coelho
Cyathaspidida	class	Pteraspidomorphi
Hikaru_Matsunaga	successor	Toshiki_Kaifu
Live_Twice_(song)	album	Live_Twice_(album)
Dualstar	keyPerson	Mary-Kate_Olsen
2014_Orlando_City_SC_season	season	2014_USL_Pro_season
Micromonosporaceae	order	Micromonosporaceae
The_Andromeda_Strain_(miniseries)	producer	Tom_Thayer
The_Moon_and_the_Sun_(film)	starring	Kaya_Scodelario
The_Good_Night	distributor	Yari_Film_Group
John_A._Mead	birthPlace	Fair_Haven,_Vermont
Atlético_Choloma	honours	Liga_Nacional_de_Ascenso_de_Honduras
Bâsca_Chiojdului_River	rightTributary	Chiojdul_River_(Bâsca_Chiojdului)
Dimorphoceratidae	order	Goniatitina
Siraj_Ali	residence	Stanford-le-Hope
Heinrich_Schönfeld	team	Hakoah_All-Stars
Adoniram_J._Holmes	birthPlace	Wooster,_Ohio
Ouidah	isPartOf	Atlantique_Department
Truro,_Nova_Scotia	leaderName	Bill_Casey
Mozilla_Thunderbird	developer	Mozilla_Foundation
Addington_Parish,_New_Brunswick	type	List_of_parishes_in_New_Brunswick
The_Commander_(TV_series)	starring	Anthony_Valentine
Michigan_City,_Mississippi	isPartOf	Benton_County,_Mississippi
Vittsjö_GIK	ground	Vittsjö
James_T._Moore	field	Atmospheric_sciences
Double_Helix_(The_Outer_Limits)	writer	Jonathan_Glassner
Laverne_&_Shirley	composer	John_Beal_(composer)
Kip_Thorne	birthPlace	Logan,_Utah
Jean_Lesage	deathPlace	Sillery,_Quebec_City
Mario_Čižmek	team	NK_Kamen_Ingrad
No._4_Squadron_RAAF	aircraftRecon	Taylorcraft_Auster
Mozilla_Thunderbird	genre	Newsreader_(Usenet)
Tengréla_Department	isPartOf	Savanes_District
Thomas_H._Bayly	birthPlace	Accomac,_Virginia
George_Cawkwell	education	King's_College,_Auckland
Doug_Martsch	birthPlace	Twin_Falls,_Idaho
Kaiping	isPartOf	Jiangmen
Kazuhiro_Haraguchi	birthPlace	Saga,_Saga
Thomas_Spira	employer	University_of_Prince_Edward_Island
The_Arcs	bandMember	Nick_Movshon
Mario_Visintini	birthPlace	Poreč
Asher_G._Caruth	successor	Albert_S._Berry
Dovrat_Bendel	team	ASA_Tel_Aviv_University
Thomas_Luke	militaryUnit	No._56_Squadron_RAF
Mary_Harriman_Rumsey	relation	E._Roland_Harriman
Marshall_Formby	region	Bailey_County,_Texas
The_Young_Doctors	director	Michael_Pattinson
Vandalism_(band)	formerBandMember	Vandalism_(band)
Embraer	foundedBy	Federal_government_of_Brazil
The_Ghost_Train_(1941_film)	starring	Richard_Murdoch
7th_Infantry_Division_(Philippines)	notableCommander	Hermogenes_Esperon
World_Outside_Your_Window	producer	Rod_Argent
Craig_L._Thomas	region	Wyoming's_at-large_congressional_district
Moshe_Lugasi	birthPlace	Kiryat_Gat
Trichuris	order	Trichocephalida
Siege_of_Bihać	place	Siege_of_Bihać
A_Smile_Like_Yours	starring	Jill_Hennessy
Scruples_(miniseries)	starring	Nick_Mancuso
Rock_On_(Raydio_album)	artist	Raydio
DonTrell_Moore	formerTeam	New_Mexico_Stars
Orient,_New_York	isPartOf	Southold_(town),_New_York
Derek_Campbell	formerTeam	Manchester_Phoenix
