Openings_(The_Killing)	guest	Barclay_Hope
The_Boondocks_(TV_series)	voice	Jill_Talley
Beside_the_Dying_Fire	guest	Lauren_Cohan
The_Final_Sanction_(novel)	nonFictionSubject	Second_Doctor
Martin_Carthy	associatedBand	The_Imagined_Village
Black_Forest_Railway_(Württemberg)	typeOfElectrification	15_kV_AC_railway_electrification
Billy_Dee_Williams	education	Fiorello_H._LaGuardia_High_School
Carlo_Festuccia	birthPlace	L'Aquila
Two_Hearts_Beat_as_One	previousWork	New_Year's_Day_(song)
Bentley_S3	relatedMeanOfTransportation	Bentley_S3
Joseph_A._A._Burnquist	governor	Winfield_Scott_Hammond
Never_for_Ever	subsequentWork	The_Dreaming_(album)
Said_Halim_Pasha	predecessor	Mahmud_Shevket_Pasha
Stephen_Mandel	almaMater	University_of_Windsor
Dharan,_Nepal	timeZone	Nepal_Standard_Time
Rhodium_Nights	subsequentWork	Lost_Reputation
Stade_Numa-Daly_Magenta	tenant	A.S._Magenta
Peter_Guy_Wolynes	field	Chemical_physics
Natasha_Purich	formerPartner	Mervin_Tran
Screamer	class	Fowl
Unorganized_Borough,_Alaska	largestCity	Bethel,_Alaska
WJMN_(FM)	sisterStation	WBWL_(FM)
Mahakali_Zone	timeZone	Nepal_Standard_Time
Newswipe_with_Charlie_Brooker	related	Charlie_Brooker's_Weekly_Wipe
Union_for_Democracy_and_Social_Progress_(Democratic_Republic_of_the_Congo)	chairperson	Étienne_Tshisekedi
Kanjani_Eight	bandMember	Kanjani_Eight
Archduke_Franz_Salvator_of_Austria	spouse	Archduchess_Marie_Valerie_of_Austria
Alternate_Reality_(series)	publisher	Datasoft
Wongsonegoro	successor	Bahder_Djohan
Winston_Stanley_(rugby_union)	relative	Joe_Stanley
Swamp_Ophelia	previousWork	Rites_of_Passage_(Indigo_Girls_album)
A._M._Paraman	successor	P._P._George
Discovery_Shed	sisterStation	TLC_(UK_and_Ireland)
Flirt_(1995_film)	cinematography	Michael_Spiller
Queen_of_Peace_(song)	subsequentWork	Delilah_(Florence_and_the_Machine_song)
Bodies_(TV_series)	starring	Neve_McIntosh
Sat_in_Your_Lap	album	The_Dreaming_(album)
Sir_Charles_Clifford,_1st_Baronet	successor	William_Barnard_Rhodes
Melissa_Coates	trainer	Afa_Anoaʻi
Cook,_Minnesota	isPartOf	St._Louis_County,_Minnesota
Dying_in_the_Sun	nonFictionSubject	Second_Doctor
Grant_Pointer	school	Gresham's_School
Jon_Gruden	birthPlace	Sandusky,_Ohio
Robin_Kelly	region	Illinois's_2nd_congressional_district
Joshua_Ang	associatedAct	I_Not_Stupid_Too
Christian_Porter	successor	Colin_Barnett
Daniel_Andrews	successor	Tony_Robinson_(politician)
Cyanide_(song)	previousWork	My_Apocalypse
The_Client_List	composer	Richard_Marvin_(composer)
Xu_Guangqi	deathPlace	Zhili
Cold_as_Ice_(Foreigner_song)	writer	Mick_Jones_(Foreigner_guitarist)
Dog_Eat_Dog_(Joni_Mitchell_album)	previousWork	Wild_Things_Run_Fast
Vow_(song)	recordLabel	Almo_Sounds
A.S._Magenta	ground	Stade_Numa-Daly_Magenta
2009–10_AFC_Wimbledon_season	ground	Kingsmeadow
Osinakachukwu_Ideozu	almaMater	Rivers_State_University_of_Science_and_Technology
Tonight_(Luna_Sea_song)	album	Lunacy_(album)
Pyuthan_Municipality	timeZone	Nepal_Standard_Time
Fencing_at_the_1992_Summer_Olympics_–_Men's_team_foil	previousEvent	Fencing_at_the_1988_Summer_Olympics_–_Men's_team_foil
Pappy_Sherrill	birthPlace	Sherrills_Ford,_North_Carolina
Mannchalay	starring	Sanam_Baloch
Time_Will_Crawl	previousWork	Day-In_Day-Out
Rusca_River_(Timiș)	leftTributary	Rușchița_River
Eurasian_teal	order	Fowl
Jean-Louis_Barrault	spouse	Madeleine_Renaud
David_Siderovski	field	Medical_education
The_New_Year_(band)	associatedMusicalArtist	Will_Johnson_(musician)
Sword_of_Venus	writer	Aubrey_Wisberg
Viva_Riva!	language	Lingala
Day-In_Day-Out	subsequentWork	Time_Will_Crawl
Machala	timeZone	Time_in_Ecuador
Bone_Tomahawk	starring	Patrick_Wilson_(American_actor)
Gennadi_Remezov	team	FC_Buran_Voronezh
Can't_Let_Go_(Mariah_Carey_song)	previousWork	Emotions_(Mariah_Carey_song)
Stay_My_Baby	musicalArtist	Amy_Diamond
A_State_of_Trance_2010	subsequentWork	A_State_of_Trance_2011
Deadguy	associatedBand	Rorschach_(band)
Greatest_Hits_(Billy_Joel_albums)	producer	Mick_Jones_(Foreigner_guitarist)
Hal_Linden	education	Fiorello_H._LaGuardia_High_School
Isagenix_International	locationCity	Gilbert,_Arizona
You_Are_in_My_System	writer	Mic_Murphy
Doctor_Fink	associatedBand	Vanity_6
Duncan_Lamont	deathPlace	Royal_Tunbridge_Wells
Vodafone_Hutchison_Australia	product	Prepaid_mobile_phone
Genes_(album)	producer	Dave_Couse
We_Danced	subsequentWork	Two_People_Fell_in_Love
Chappaqua_(film)	starring	Jean-Louis_Barrault
Ebusua_Dwarfs	league	First_Capital_Plus_Premier_League
Fasciinatiion	previousWork	Wet_from_Birth
2009_in_Strikeforce	previousEvent	2009_in_Strikeforce
Dave_Trumfio	recordLabel	Almo_Sounds
Colin_Barnett	predecessor	Christian_Porter
Poison_Ivy:_The_Secret_Society	author	Peter_Sullivan_(screenwriter)
The_Spiders_(Japanese_band)	associatedBand	Vodka_Collins
Highbridge,_Somerset	region	South_West_England_(European_Parliament_constituency)
Light_Fingers	trainer	Bart_Cummings
Staffanstorp	isPartOf	Staffanstorp_Municipality
Twisting_and_Shouting	previousWork	Twist_&_Shout_(album)
Jeff_Fatt	birthPlace	Casino,_New_South_Wales
Vodafone_Hutchison_Australia	owningCompany	CK_Hutchison_Holdings
Rolls-Royce_Silver_Dawn	successor	Rolls-Royce_Silver_Cloud
A_New_Day_at_Midnight	previousWork	The_EPs_1992–1994
Acorán_Barrera_Reyes	team	CD_Corralejo
Assicurazioni_Generali	keyPerson	Chief_investment_officer
KYAP	broadcastArea	Laramie,_Wyoming
Navajeros	starring	José_Sacristán
KAMP-FM	sisterStation	KRTH
Whitesboro,_New_York	isPartOf	Oneida_County,_New_York
Lost_Reputation	previousWork	Rhodium_Nights
Deadguy	associatedMusicalArtist	Rorschach_(band)
Randy_Hultgren	residence	Plano,_Illinois
Mahmud_Shevket_Pasha	successor	Said_Halim_Pasha
John_R._Ingram_(businessman)	relative	David_B._Ingram
Dave_Bowman_(footballer,_born_1964)	birthPlace	Royal_Tunbridge_Wells
Picton,_New_Zealand	isPartOf	Marlborough_Region
Patterns_of_Force_(Star_Trek:_The_Original_Series)	guest	David_Brian
Cabonga_Reservoir	location	La_Vallée-de-la-Gatineau_Regional_County_Municipality
Neal_Casal	hometown	Denville_Township,_New_Jersey
A_State_of_Trance_2011	previousWork	A_State_of_Trance_2010
The_Nine_Lives_of_Fritz_the_Cat	starring	Bob_Holt_(actor)
Madeleine_Renaud	spouse	Jean-Louis_Barrault
Mervin_Tran	formerPartner	Natasha_Purich
Phil_Woolas	successor	Debbie_Abrahams
Theri_(film)	starring	Samantha_Ruth_Prabhu
Xu_Guangqi	employer	Chongzhen_Emperor
Eyes_on_Me_(Superfly_song)	album	Mind_Travel
Booby	order	Suliformes
Lagonoy_Gulf	nearestCity	Tabaco
Plains_Garter_Snake	binomialAuthority	Charles_Frédéric_Girard
Rorschach_(band)	associatedBand	Deadguy
Salcedo_Canton	timeZone	Time_in_Ecuador
Sturminster_Newton	district	North_Dorset
Murder_of_Tia_Rigg	bodyDiscovered	Cheetham_Hill
Back_to_the_'50s	author	Paul_Alexander_(British_writer)
Dharan,_Nepal	isPartOf	Sunsari_District
Kihntagious	producer	Matthew_King_Kaufman
Chipe_Libre	channel	Canal_13_(Chile)
Yarmouth_County,_Nova_Scotia	isPartOf	Argyle,_Nova_Scotia
The_Accused_(1960_film)	writer	The_Accused_(1960_film)
Giorgio_Chinaglia	team	S.S.D._Puteolana_1902_Internapoli
Koca_Mehmed_Nizamüddin_Pasha	successor	Çandarlı_Halil_Pasha_the_Younger
The_Accused_(1960_film)	producer	The_Accused_(1960_film)
Mantovani	deathPlace	Royal_Tunbridge_Wells
I_Not_Stupid_Too	starring	Joshua_Ang
Joseph_S._Nelson	knownFor	Ichthyology
Step_Back/Slide	subsequentWork	7_Years_(Superheist_song)
Brad_Pfaff	almaMater	University_of_Wisconsin–Green_Bay
Ricardo_López_Murphy	predecessor	José_Luis_Machinea
Delilah_(Florence_and_the_Machine_song)	previousWork	Queen_of_Peace_(song)
Natasha_Purich	formerCoach	Ravi_Walia
Xenophobe_(video_game)	computingPlatform	Atari_Lynx
111_Street,_Edmonton	routeEnd	Argyll_Road,_Edmonton
John_Wayles_Jefferson	relative	Madison_Hemings
Brandenburg,_Kentucky	isPartOf	Meade_County,_Kentucky
The_Incredible_Hulk_(1982_TV_series)	voice	Bob_Holt_(actor)
Face_to_Face_(punk_band)	associatedBand	Viva_Death
Battle_of_Sedan	place	Sedan,_Ardennes
Keep_It_Dark	album	Abacab
Wildflower_(Superfly_song)	subsequentWork	Eyes_on_Me_(Superfly_song)
Radiola	artist	Skank_(band)
Henry_Isaac	team	Sandefjord_Fotball
No_Letting_Go	previousWork	Something_Different_(song)
Galmudug	largestCity	Galkayo
2009–10_AFC_Wimbledon_season	league	National_League_(English_football)
Redoute's_Choice	race	Manikato_Stakes
Alternate_Reality_(series)	computingPlatform	Commodore_128
Love_on_the_Telephone	producer	Mick_Jones_(Foreigner_guitarist)
Dublin–Navan_railway_line	isPartOf	Iarnród_Éireann
Otto_of_Greece	restingPlace	Theatine_Church,_Munich
Charles_Armand_Tuffin,_marquis_de_la_Rouerie	award	Order_of_Saint_Louis
You_Take_the_Kids	director	Frank_Bonner
Minamikyushu_Expressway	city	Satsumasendai,_Kagoshima
Ellen_Hamlin	successor	Eliza_McCardle_Johnson
P._P._George	region	Chalakudy
Maskerade	nonFictionSubject	Ankh-Morpork
A3_road_(Northern_Ireland)	routeJunction	Armagh
Augustin_de_Lespinasse	battle	Battle_of_Castiglione
Panzer_General	developer	Strategic_Simulations
Manchurian_wapiti	species	Elk
The_Message_(2009_film)	starring	Zhang_Hanyu
Ted_Baillieu	successor	Daniel_Andrews
Kasba,_Kolkata_(Vidhan_Sabha_constituency)	isPartOf	South_24_Parganas_district
Chris_Christian_(soccer)	team	Villanova_Wildcats
Christian_Porter	predecessor	Scott_Morrison_(politician)
Eel_River_(California)	leftTributary	South_Fork_Eel_River
Gooderham_and_Worts	keyPerson	George_Horace_Gooderham
Blondes_(Have_More_Fun)	previousWork	Ain't_Love_a_Bitch
WJMN_(FM)	sisterStation	WKOX_(AM)
Hermiswil	neighboringMunicipality	Steinhof
Takayuki_Yamada	birthPlace	Satsumasendai,_Kagoshima
Birger_Madsen	team	Sandefjord_Fotball
Chivasso	province	Metropolitan_City_of_Turin
Xu_Guangqi	birthPlace	Minhang_District
Patricia_Driscoll	spouse	Duncan_Lamont
Keerthi_Chakra_(film)	starring	Jiiva
Preshafood	predecessor	Preshafood
Neil_Jablonski	birthPlace	Glenrothes
Duncan_Lamont	spouse	Patricia_Driscoll
When_the_Wind_Blows_(song)	subsequentWork	Day-In_Day-Out
WBTT	broadcastArea	Cape_Coral,_Florida
Sex,_Age_&_Death	previousWork	The_Happy_Club
2004–05_AFC_Wimbledon_season	ground	Kingsmeadow
Dark_Lady_(song)	previousWork	Carousel_Man
Amaqhawe	subsequentWork	Ukusindiswa
The_Groomsmen	starring	Jessica_Capshaw
Evergreen_Group	subsidiary	Evergreen_Group
Prince_Aimone,_Duke_of_Aosta	parent	Prince_Emanuele_Filiberto,_Duke_of_Aosta
Robin_Kelly	successor	Al_Riley
Lexington,_Oklahoma	isPartOf	Cleveland_County,_Oklahoma
Monkey_Dust	starring	Frances_Barber
Face_to_Face_(punk_band)	associatedMusicalArtist	Me_First_and_the_Gimme_Gimmes
The_Dreaming_(album)	previousWork	Never_for_Ever
Ken_Mayes	birthPlace	Wickford
Eliza_McCardle_Johnson	predecessor	Ellen_Hamlin
Reaper_Man	nonFictionSubject	Ankh-Morpork
Carrara	frazioni	Carrara
WCOS-FM	sisterStation	WXBT
José_Luis_Machinea	successor	Ricardo_López_Murphy
The_Message_(2009_film)	director	Chen_Kuo-Fu
WBWL_(FM)	sisterStation	WJMN_(FM)
Lee_County,_Kentucky	countySeat	Beattyville,_Kentucky
Music_Box_(Mariah_Carey_album)	previousWork	MTV_Unplugged_(Mariah_Carey_EP)
Jean-Baptiste_Donatien_de_Vimeur,_comte_de_Rochambeau	award	Order_of_Saint_Louis
The_Mysterious_Castle_in_the_Carpathians	writer	Jiří_Brdečka
Coon_Rapids,_Iowa	isPartOf	Carroll_County,_Iowa
Hollywood_(Michael_Bublé_song)	album	Crazy_Love_(Michael_Bublé_album)
Terry_Cafolla	birthPlace	Armagh
Osaka_Obachan_Rock/Osaka_Romanesque	musicalBand	Kanjani_Eight
WBWL_(FM)	sisterStation	WKOX_(AM)
Advanced_Digital_Broadcast	product	Set-top_box
Face_to_Face_(punk_band)	bandMember	Face_to_Face_(punk_band)
Neethaane_En_Ponvasantham	starring	Samantha_Ruth_Prabhu
Queen_of_Memphis	album	Confederate_Railroad_(album)
Genes_(album)	subsequentWork	Dave_Couse
Markus_J._Buehler	field	Biomechanics
Gadwall	genus	Anas
Yeovil	region	South_West_England_(European_Parliament_constituency)
San_Francisco_de_Macorís	isPartOf	Duarte_Province
Wind_Mobile	product	Smartphone
John_Amsden_Starkweather	doctoralAdvisor	Carl_Porter_Duncan
Richard_Thomas_Lowe	field	Ichthyology
Frankfurt–Hanau_(south_bank)_railway	typeOfElectrification	15_kV_AC_railway_electrification
Carter_Harrison,_Sr.	birthPlace	Fayette_County,_Kentucky
Södertälje_Kings	league	FIBA_Europe_Cup
Narapati_I_of_Ava	deathPlace	Pyay
Selawik,_Alaska	leaderName	Donny_Olson
Rorschach_(band)	formerBandMember	Rorschach_(band)
2014–15_CS_Constantine_season	homeStadium	Stade_Mohamed_Hamlaoui
Neethaane_En_Ponvasantham	starring	Jiiva
Tommy_McClennan	associatedMusicalArtist	Robert_Petway
WKOX_(AM)	sisterStation	WJMN_(FM)
Opening_Night_(Glee)	subsequentWork	The_Back-up_Plan_(Glee)
Mr._&_Mrs._Smith_(song)	album	Bombshell_(Smash_album)
Whale_Rider	starring	Whale_Rider
Dublin–Navan_railway_line	owner	Iarnród_Éireann
Fencing_at_the_1988_Summer_Olympics_–_Men's_team_foil	nextEvent	Fencing_at_the_1992_Summer_Olympics_–_Men's_team_foil
Rigas_Feraios	influenced	Greek_War_of_Independence
Charles_J._Noyes	birthPlace	Haverhill,_Massachusetts
Central_Avenue_(Albuquerque,_New_Mexico)	county	Bernalillo_County,_New_Mexico
Eyes_on_Me_(Superfly_song)	previousWork	Wildflower_(Superfly_song)
Diving_at_the_2016_Summer_Olympics	event	Diving
Valinhos	timeZone	Daylight_saving_time_in_Brazil
Me_and_Mrs_Jones_(TV_series)	starring	Me_and_Mrs_Jones_(TV_series)
Wildflower_(Superfly_song)	album	Mind_Travel
Lee_County,_Kentucky	largestCity	Beattyville,_Kentucky
Arthur_Seymour	deathPlace	Picton,_New_Zealand
2009_in_Strikeforce	followingEvent	2009_in_Strikeforce
Bentley_S3	relatedMeanOfTransportation	Rolls-Royce_Silver_Cloud
Jennifer_Lee_(filmmaker)	birthPlace	East_Providence,_Rhode_Island
Stathi_Katsidis	race	Manikato_Stakes
Dendrocopos	family	Picinae
Alternate_Reality_(series)	designer	Alternate_Reality_(series)
Robert_White_(attorney_general)	relation	Robert_White_(West_Virginia_senator)
Yo_soy_Betty,_la_fea	executiveProducer	Yo_soy_Betty,_la_fea
Bondoukou	isPartOf	Bondoukou_Department
Doctor_Fink	associatedMusicalArtist	Vanity_6
Ricardo_Zielinski	managerClub	Club_Atlético_Ituzaingó
Langelurillus	family	Aelurillinae
Lester_Roloff	birthPlace	Navarro_County,_Texas
Gangster_(2006_film)	starring	Kangana_Ranaut
NPO_Sport	owningCompany	Dutch_public_broadcasting_system
KFLC	city	Benbrook,_Texas
Los_Ríos_Province	timeZone	Time_in_Ecuador
3_Dancing_Slaves	starring	Aure_Atika
Eric_Opoku	team	Cornerstones
Kuch_Pyar_Ka_Pagalpan	starring	Sanam_Baloch
WXBT	city	West_Columbia,_South_Carolina
WXBT	sisterStation	WCOS-FM
Étienne_Tshisekedi	party	Union_for_Democracy_and_Social_Progress_(Democratic_Republic_of_the_Congo)
Robert_Petway	associatedBand	Tommy_McClennan
Cologne–Lindlar_railway	typeOfElectrification	15_kV_AC_railway_electrification
Advanced_Digital_Broadcast	product	Digital_video_recorder
Sacrifice_(The_Following)	guest	Valerie_Cruz
Jordan_Johnson_(footballer)	team	Airbus_UK_Broughton_F.C.
The_Town_of_No_Return	guest	Patrick_Newell
Poison_Ivy:_The_Secret_Society	company	New_Line_Home_Entertainment
The_Mojo_Men	recordLabel	Autumn_Records
Mal_Colston	party	Mal_Colston
KRTH	sisterStation	KAMP-FM
Speed_Zone	starring	John_Candy
Rolls-Royce_Silver_Cloud	predecessor	Rolls-Royce_Silver_Dawn
28_Days	formerBandMember	28_Days
Kaththi	starring	Samantha_Ruth_Prabhu
Ricardo_Zielinski	team	Club_Atlético_Ituzaingó
Albert_Pechan	region	Butler_County,_Pennsylvania
Simon_Binks	associatedBand	Australian_Crawl
Rusca_River_(Timiș)	rightTributary	Lozna_River_(Rusca)
Disarmonia_Mundi	associatedMusicalArtist	Blood_Stain_Child
T._Raghavaiah	monarch	Rajagopala_Tondaiman
John_Hemings	relative	John_Wayles_Jefferson
Spunge	recordLabel	Spunge
Yo_soy_Betty,_la_fea	person	Yo_soy_Betty,_la_fea
Mahakali_Zone	type	List_of_zones_of_Nepal
National_Lampoon's_Vacation	starring	John_Candy
The_Nutcracker_Prince	distributor	Cineplex_Entertainment
Yo_soy_Betty,_la_fea	openingTheme	Yo_soy_Betty,_la_fea
Splendor_in_the_Grass	writer	William_Inge
The_20th_Century_Fox_Mambo	subsequentWork	Mr._&_Mrs._Smith_(song)
Robert_Petway	associatedMusicalArtist	Tommy_McClennan
Wet_from_Birth	subsequentWork	Fasciinatiion
The_New_Year_(band)	associatedBand	Will_Johnson_(musician)
The_Spiders_(Japanese_band)	associatedMusicalArtist	Vodka_Collins
Beat_Is_on_the_Brat	previousWork	Television_City_Dream
Control_Module_Industries	keyPerson	Comptroller
A.S._Mont-Dore	ground	Stade_Numa-Daly_Magenta
WGIT	city	Canóvanas,_Puerto_Rico
Two_People_Fell_in_Love	previousWork	We_Danced
Winfield_Scott_Hammond	lieutenant	Joseph_A._A._Burnquist
Twist_&_Shout_(album)	subsequentWork	Twisting_and_Shouting
The_Mysterious_Castle_in_the_Carpathians	writer	Oldřich_Lipský
Lea_County,_New_Mexico	largestCity	Hobbs,_New_Mexico
Fishbone_(EP)	subsequentWork	In_Your_Face_(Fishbone_album)
Stay_My_Baby	musicalBand	Amy_Diamond
Craig,_Alaska	isPartOf	Unorganized_Borough,_Alaska
Mentor_Zhubi	team	Assyriska_BK
Ukusindiswa	previousWork	Amaqhawe
Garuda_Municipality	timeZone	Nepal_Standard_Time
Cursed_Earth_Asylum	literaryGenre	Mega-City_One
Oneida_Lake	location	Oneida_County,_New_York
Dublin–Navan_railway_line	operatedBy	Iarnród_Éireann
Pedro_Avilés_Pérez	birthPlace	Badiraguato_Municipality
KCOY-TV	location	Santa_Maria,_California
It's_Tricky_(horse)	breeder	Stonerside_Stable
Navarro_County,_Texas	countySeat	Corsicana,_Texas
Flesh_Tone	previousWork	The_Hits_(Kelis_album)
Zvi_Sherf	coachedTeam	Hapoel_Jerusalem_B.C.
Welcome_to_the_House	starring	Christine_Ng
Sir_Charles_Clifford,_1st_Baronet	associate	William_Barnard_Rhodes
Australian_Crawl	formerBandMember	Simon_Binks
The_Murder_Trial_of_Doctor_Jordan	starring	Margarete_Haagen
Bondoukou	isPartOf	Gontougo
Argyle,_Nova_Scotia	isPartOf	Yarmouth_County,_Nova_Scotia
Al_Riley	residence	Olympia_Fields,_Illinois
Gut_Check_(NCIS)	guest	Gideon_Emery
Reaper_Man	nonFictionSubject	Discworld_(world)
Good_Friend_and_a_Glass_of_Wine	previousWork	Nothin'_Better_to_Do
U.S._Route_1_in_South_Carolina	routeJunction	West_Columbia,_South_Carolina
Jack_R._Gage	predecessor	John_J._Hickey
Players_(Doctor_Who_novel)	nonFictionSubject	Second_Doctor
Ten_Feet_Tall	subsequentWork	Dynamite_(Afrojack_song)
Jessie_Belle_Smothers	trainer	Ohio_Valley_Wrestling
Voldemārs_Veiss	award	Order_of_the_Three_Stars
Greater_white-fronted_goose	order	Fowl
Tommy_McClennan	associatedBand	Robert_Petway
Kalam_Mooniaruck	birthPlace	Yeovil
John_Fullerton_Evetts	deathPlace	Royal_Tunbridge_Wells
Silliman_University	affiliation	Association_of_Christian_Universities_and_Colleges_in_Asia
Robert_White_(West_Virginia_senator)	relation	Robert_White_(attorney_general)
WTQR	sisterStation	WPTI
Bolívar_Province_(Ecuador)	timeZone	Time_in_Ecuador
Mario_Millo	associatedMusicalArtist	Sebastian_Hardie
Joanne_Simpson	award	Carl-Gustaf_Rossby_Research_Medal
Daniel_Andrews	predecessor	Ted_Baillieu
Face_to_Face_(punk_band)	associatedBand	Me_First_and_the_Gimme_Gimmes
Bethel,_Alaska	isPartOf	Unorganized_Borough,_Alaska
Frank_W._J._Olver	award	United_States_Department_of_Commerce
WKOX_(AM)	sisterStation	WBWL_(FM)
111_Street,_Edmonton	routeJunction	Argyll_Road,_Edmonton
Sulla's_first_civil_war	commander	Gaius_Marius
Aasai_Aasaiyai	starring	Jiiva
U.S._Route_54	routeJunction	U.S._Route_54
Jennifer_Lee_(filmmaker)	knownFor	Frozen_(2013_film)
Mr._&_Mrs._Smith_(song)	previousWork	The_20th_Century_Fox_Mambo
Simon_Binks	associatedMusicalArtist	Australian_Crawl
Ganga_Yamuna_Saraswati	openingTheme	Hariharan_(singer)
2014–15_Northampton_Town_F.C._season	homeStadium	Sixfields_Stadium
Ek_Rishta_Aisa_Bhi	starring	Ek_Rishta_Aisa_Bhi
Eolambia	order	Iguanodontia
2004–05_AFC_Wimbledon_season	homeStadium	Kingsmeadow
Moro_United_F.C.	ground	Morogoro
Letcher_County,_Kentucky	countySeat	Whitesburg,_Kentucky
Wongsonegoro	predecessor	Bahder_Djohan
Godzilla	series	Godzilla_(franchise)
General_Stevenson	birthPlace	Padiham
Frozen_(2013_film)	writer	Jennifer_Lee_(filmmaker)
Piedmont_Airlines	parentCompany	American_Airlines_Group
The_Nativity_Story	starring	Keisha_Castle-Hughes
Wisconsin_Highway_32	routeJunction	Grafton,_Wisconsin
In_Your_Face_(Fishbone_album)	previousWork	Fishbone_(EP)
Southern_Utah_University	city	Cedar_City,_Utah
El_Verger	isPartOf	Dénia
P._P._George	predecessor	A._M._Paraman
The_Child_and_the_Killer	starring	Patricia_Driscoll
Navarro_County,_Texas	largestCity	Corsicana,_Texas
Corsicana,_Texas	isPartOf	Navarro_County,_Texas
Augustin_de_Lespinasse	award	Order_of_Saint_Louis
The_Skinners'_School	city	Royal_Tunbridge_Wells
Nothin'_Better_to_Do	subsequentWork	Good_Friend_and_a_Glass_of_Wine
Lagonoy_Gulf	nearestCity	Virac,_Catanduanes
Nikki_Marshall	team	Colorado_Buffaloes
Dungeons_&_Dragons_(TV_series)	voice	Bob_Holt_(actor)
Kentucky_River	origin	Beattyville,_Kentucky
Cramerton,_North_Carolina	isPartOf	Gaston_County,_North_Carolina
Babooshka_(song)	album	Never_for_Ever
My_Apocalypse	subsequentWork	Cyanide_(song)
Scott_Morrison_(politician)	successor	Christian_Porter
Beinn_Ìme	mountainRange	Grampian_Mountains
Rites_of_Passage_(Indigo_Girls_album)	subsequentWork	Swamp_Ophelia
Rasoherina	successor	Ranavalona_II
Carousel_Man	subsequentWork	Dark_Lady_(song)
Sultanah_Bahiyah_Highway	routeJunction	Darul_Aman_Highway
Sicignano_degli_Alburni	frazioni	Sicignano_degli_Alburni
Tisa_River_(Șimon)	riverMouth	Șimon_River
George_N._Parks	restingPlace	Hadley,_Massachusetts
Andrew_Bulumakau	formerTeam	Gloucester_Rugby
Harrison_Reed_(politician)	birthPlace	Littleton,_Massachusetts
Chaconiaceae	class	Pucciniomycetes
Osinakachukwu_Ideozu	almaMater	University_of_Port_Harcourt
Meade_County,_Kentucky	countySeat	Brandenburg,_Kentucky
Amba_Shepherd	associatedMusicalArtist	Ferry_Corsten
2014–15_CS_Constantine_season	ground	Stade_Mohamed_Hamlaoui
The_Hits_(Kelis_album)	subsequentWork	Flesh_Tone
Indictment:_The_McMartin_Trial	author	Abby_Mann
Löhne–Rheine_railway	typeOfElectrification	15_kV_AC_railway_electrification
Spunge	formerBandMember	Spunge
Franciszek_Ksawery_Lampi	deathPlace	Partitions_of_Poland
WPTI	sisterStation	WTQR
MTV_Unplugged_(Mariah_Carey_EP)	subsequentWork	Music_Box_(Mariah_Carey_album)
Eunice,_New_Mexico	isPartOf	Lea_County,_New_Mexico
TLC_(UK_and_Ireland)	sisterStation	Discovery_Shed
Twist_&_Shout_(album)	recordLabel	Wand_Records
Çandarlı_Halil_Pasha_the_Younger	predecessor	Koca_Mehmed_Nizamüddin_Pasha
Margaret_Larkin	birthPlace	Las_Vegas,_New_Mexico
Eurasian_teal	genus	Anas
Argyll_Road,_Edmonton	routeJunction	111_Street,_Edmonton
Ferrari_599_GTB_Fiorano	relatedMeanOfTransportation	Ferrari_612_Scaglietti
WKOX_(AM)	city	Everett,_Massachusetts
Thomas_W._Benoist	deathPlace	Sandusky,_Ohio
Winfield_Scott_Hammond	successor	Joseph_A._A._Burnquist
Ferrari_599_GTB_Fiorano	successor	Ferrari_F12berlinetta
Mariza	genre	Fado
The_Murder_Trial_of_Doctor_Jordan	starring	Maria_Holst
Mansi_people	religion	Shamanism
Secrets_(The_Walking_Dead)	guest	Lauren_Cohan
Drop_Dead_Gorgeous_(film)	cinematography	Michael_Spiller
Elias_Andra	associatedBand	Elias_Andra
Whiteout_(Judge_Dredd_novel)	literaryGenre	Mega-City_One
Patan,_Nepal	timeZone	Nepal_Standard_Time
Zamora-Chinchipe_Province	timeZone	Time_in_Ecuador
Dan_Smoot	birthPlace	East_Prairie,_Missouri
François_de_Fleury	award	Order_of_Saint_Louis
KISV	sisterStation	KKXX-FM
Joseph_Chabran	award	Order_of_Saint_Louis
Villanova_Wildcats	city	Villanova,_Pennsylvania
Aminatou_Haidar	residence	Western_Sahara
Boyd_Jarvis	associatedMusicalArtist	Boyd_Jarvis
Ulick_de_Burgh,_1st_Marquess_of_Clanricarde	predecessor	John_Lambton,_1st_Earl_of_Durham
Bart_Cummings	raceHorse	Light_Fingers
Igor_Bragin	team	FC_Buran_Voronezh
Tollyganj_(Vidhan_Sabha_constituency)	isPartOf	South_24_Parganas_district
Expand_Your_Head	producer	Lords_of_Acid
Wisconsin_Highway_32	routeJunction	Three_Lakes,_Wisconsin
Nickelodeon_(Australia_and_New_Zealand)	sisterStation	MTV_Classic_(Australia_and_New_Zealand)
Proszynskiana	family	Aelurillinae
Australian_Crawl	formerBandMember	David_Reyne
Alpheus_tricolor	family	Alpheoidea
Berekum_Arsenal	league	First_Capital_Plus_Premier_League
Trashy_Women	album	Confederate_Railroad_(album)
KMID	sisterStation	KPEJ-TV
Parameciidae	class	Oligohymenophorea
Hürriyet_Gücer	birthPlace	Nevşehir
Players_(Doctor_Who_novel)	author	Terrance_Dicks
Clay_City,_Indiana	isPartOf	Harrison_Township,_Clay_County,_Indiana
Light_Fingers	race	Makybe_Diva_Stakes
Louis_E._Brus	award	Kavli_Prize
3_Dancing_Slaves	writer	Christophe_Honoré
Ali_Hamsa	birthPlace	Kluang
Ultima_V:_Warriors_of_Destiny	computingPlatform	Commodore_128
Critical_(TV_series)	starring	Neve_McIntosh
Ganga_Yamuna_Saraswati	starring	M._S._Bhaskar
Yummy_Yummy_(album)	producer	Jeff_Fatt
Dinis_Vital	team	Lusitano_G.C.
Raju_Kaji_Shakya	birthPlace	Dharan,_Nepal
Red_Creek,_New_York	isPartOf	Wayne_County,_New_York
2011–12_S.S._Lazio_season	chairman	Claudio_Lotito
SUNY_Polytechnic_Institute	city	Marcy,_New_York
People_in_Planes	hometown	Porthcawl
Bettles,_Alaska	leaderName	Donny_Olson
Yaw_Ihle_Amankwah	team	Sandefjord_Fotball
WNCY-FM	city	Neenah,_Wisconsin
My_Damnation	recordedIn	Hadley,_Massachusetts
New_Beginnings_(TV_series)	starring	Joshua_Ang
Slugterra:_Return_of_the_Elementals	distributor	Cineplex_Entertainment
New_Mexico_Highlands_University	city	Las_Vegas,_New_Mexico
Argyll_Road,_Edmonton	routeEnd	Old_Strathcona
Daniel_Andrews	governor	Linda_Dessau
Blackhawks_Over_Los_Angeles	previousWork	Exile_in_Oblivion
Carl_Porter_Duncan	doctoralStudent	John_Amsden_Starkweather
Flight_of_the_Intruder_(video_game)	developer	Imagineering_(company)
2012–13_St_Mirren_F.C._season	league	2012–13_Scottish_Premier_League
Whale_Rider	narrator	Keisha_Castle-Hughes
RocKihnRoll	producer	Matthew_King_Kaufman
Bistra_River_(Timiș)	rightTributary	Rusca_River_(Timiș)
Sunday_in_the_South	album	The_Road_Not_Taken_(album)
CustomInk	service	Screen_printing
David_Amaral_Rodríguez	managerClub	CD_Corralejo
The_English_Patient_(Seinfeld)	guest	Jill_Talley
Blood_and_Sand_(1941_film)	starring	Linda_Darnell
Wednesday_Addams	relative	Morticia_Addams
17_Days_(song)	writer	Doctor_Fink
Altai_people	religion	Shamanism
Brad_Scott_(New_Zealand_footballer)	team	Glenfield_Rovers
Obturator_artery	branchTo	Obturator_artery
Just_One_of_the_Guys	starring	Billy_Jayne
The_Mysterious_Castle_in_the_Carpathians	starring	Miloš_Kopecký
Duarte_Province	capital	San_Francisco_de_Macorís
Eve_(1968_film)	musicComposer	Malcolm_Lockyer
Michael_Dougall_Bell	almaMater	University_of_Windsor
Semsonsing_Ingti	almaMater	Murari_Chand_College
Minimal_Compact	bandMember	Minimal_Compact
Robert_W._Hayler	birthPlace	Sandusky,_Ohio
Rhodium_Nights	director	Norberto_Barba
Every_Time_Two_Fools_Collide_(song)	album	Every_Time_Two_Fools_Collide
Ghosttown_(Madonna_song)	album	Rebel_Heart_(Madonna_album)
Willow_ptarmigan	order	Fowl
Elliott_Wilson_(journalist)	knownFor	Elliott_Wilson_(journalist)
Simon_Binks	hometown	Mount_Eliza,_Victoria
Mint_Hill,_North_Carolina	isPartOf	Union_County,_North_Carolina
New_York_State_Route_25A	routeJunction	Fort_Salonga,_New_York
Angermünde–Stralsund_railway	typeOfElectrification	15_kV_AC_railway_electrification
Ana_Moura	genre	Fado
Melanerpes	family	Picinae
In_the_End_(Stefanie_Heinzmann_song)	writer	Romans_(musician)
De_Rosa_(band)	bandMember	De_Rosa_(band)
Victor_G._Springer	field	Ichthyology
Yannick_Noah	birthPlace	Sedan,_Ardennes
Marquee_Moon_(song)	producer	Andy_Johns
Mitchell_Cary_Alford	birthPlace	Fayette_County,_Kentucky
Ahmed_Mulay_Ali_Hamadi	birthPlace	Western_Sahara
Dishwalla	bandMember	Dishwalla
Fourteenth_Air_Force	notableCommander	Claire_Lee_Chennault
Certificates_of_Death	cinematography	Karl_Puth
Jack_White_(footballer,_born_1924)	deathPlace	Royal_Tunbridge_Wells
