Cross_Season	subsequentWork	Brightdown
Farley_Mowat	restingPlace	Port_Hope,_Ontario
Lipotrophidae	class	Gregarinasina
KVOW	sisterStation	KTHE
Black-throated_mango	family	Trochilinae
Woods_County,_Oklahoma	largestCity	Alva,_Oklahoma
Bryce_Canyon_National_Park	location	Kane_County,_Utah
Universal_Channel_(Australia)	sisterStation	E!_(Australia)
La_Copa_Junior	followingEvent	Fantastica_Mania_2016
Maine_State_Route_4	routeJunction	Farmington,_Maine
Sleepin'_with_the_Radio_On	writer	Stephen_Allen_Davis
Manvendra_Singh	spouse	Manvendra_Singh
Aylesford	district	Tonbridge_and_Malling
North_Elmham_railway_station	operatedBy	Great_Eastern_Railway
Deltatheridiidae	order	Metatheria
Can't_Fight_This_Feeling	writer	Kevin_Cronin
Korana_Longin-Zanze	formerTeam	Galatasaray_S.K._(women's_basketball)
All_the_World's_a_Stooge	starring	Olaf_Hytten
Club_Penguin:_Monster_Beach_Party	author	Martin_Olson
Carl_Harvey	associatedBand	Willi_Williams
Donner_und_Blitzen_River	riverMouth	Malheur_Lake
Ban_Johnson_Park	tenant	Detroit_Tigers
Vivian_Beaumont_Theater	operatedBy	Vivian_Beaumont_Theater
Freddy_Hall	birthPlace	St._George's,_Bermuda
Clint_Formby	restingPlace	Hereford,_Texas
The_Clambakes_Series_Vol._2	previousWork	The_Clambakes_Series_Vol._1
Westinghouse_Electric_(1886)	foundedBy	George_Westinghouse
Juan_Ramón_Loubriel_Stadium	tenant	Sevilla_FC_Puerto_Rico
The_Devil's_Share	director	Chris_Fisher
Maniac_(2012_film)	starring	Nora_Arnezeder
Douentza_Cercle	isPartOf	Mopti_Region
Spicks_and_Specks_(song)	recordLabel	Spin_Records_(Australian_label)
Uyghur_language	languageFamily	Turkic_languages
Ezgi_Çağlar	team	Turkey_women's_national_football_team
Bitches_Brew	previousWork	In_a_Silent_Way
Saturday_Night_(Jessica_Mauboy_song)	album	Get_'Em_Girls
Etchu_Tabe	birthPlace	Buea
Fantastica_Mania_2016	previousEvent	La_Copa_Junior
Cold_Blood_(TV_series)	starring	Matthew_Kelly
Equestrian_at_the_1920_Summer_Olympics_–_Team_jumping	previousEvent	Equestrian_at_the_1912_Summer_Olympics_–_Team_jumping
Freddie_Keil	associatedBand	Terry_Dean
Tubeufiaceae	class	Pleosporomycetidae
Attakathi	musicComposer	Santhosh_Narayanan
MiniD	influencedBy	Lua_(programming_language)
Jack_Pizzey	birthPlace	Childers,_Queensland
Sea_Lion_(album)	artist	The_Ruby_Suns
Eddie_Moten	formerTeam	Rio_Grande_Valley_Dorados
Dywane_Thomas,_Jr.	associatedMusicalArtist	David_Fiuczynski
Kesko	service	Car_dealership
Ribadesella_CF	position	Divisiones_Regionales_de_Fútbol_in_Asturias
Kalevala	translator	William_Forsell_Kirby
Enveloped_Ideas_(song)	subsequentWork	Salamat_(song)
Athletics_at_the_1980_Summer_Olympics_–_Women's_4_×_400_metres_relay	previousEvent	Athletics_at_the_1976_Summer_Olympics_–_Women's_4_×_400_metres_relay
Anti-Austerity_Alliance–People_Before_Profit	ideology	Eco-socialism
Draggin'_the_Line	writer	Tommy_James
Freddie_Keil	associatedMusicalArtist	Terry_Dean
Miss_America_(Måns_Zelmerlöw_song)	writer	Fredrik_Kempe
Symphony_of_Enchanted_Lands	artist	Rhapsody_of_Fire
Theo_van_Doesburg	movement	De_Stijl
Malleco_Province	part	Lonquimay
Can't_Fight_This_Feeling	producer	Kevin_Cronin
Lua_(programming_language)	influenced	MiniD
Now_You_See_Inside	subsequentWork	Tomorrow_(SR-71_album)
Clint_Formby	residence	Hereford,_Texas
Fathia_Ghali	parent	Fuad_I_of_Egypt
Goodshirt	bandMember	Goodshirt
The_Roadhouse_Murder	director	J._Walter_Ruben
James_L._Buckley	successor	Daniel_Patrick_Moynihan
Don't_Move	musicComposer	Vasco_Rossi
Peter_Gavigan	team	Vale_of_Clyde_F.C.
Yvan_Baker	residence	Etobicoke
North_Rustico	isPartOf	Queens_County,_Prince_Edward_Island
Biker_Like_an_Icon	previousWork	Off_the_Ground_(song)
Canada_98	director	Farley_Mowat
Vidhana_Soudha	owner	Government_of_Karnataka
Mapusa	isPartOf	North_Goa
Odessa_in_Flames	starring	Carlo_Ninchi
Scrape_(Blue_Stahli_song)	subsequentWork	ULTRAnumb
Aksel_Berg	militaryBranch	Imperial_Russian_Navy
Chris_Eldridge	associatedBand	Punch_Brothers
Marcus_H._Holcomb	predecessor	Simeon_Eben_Baldwin
Regional_Council_of_Lombardy	politicalPartyInLegislature	Brothers_of_Italy
Space_(Prince_song)	album	Come_(Prince_album)
Johnsonville_Branch	operatedBy	Tranz_Metro
The_Skiffle_Sessions_–_Live_in_Belfast_1998	subsequentWork	You_Win_Again_(album)
Martisberg	neighboringMunicipality	Betten
Arthur_Lee,_1st_Viscount_Lee_of_Fareham	almaMater	Cheltenham_College
Aggressor_(horse)	sire	Combat_(horse)
Slika_Hrvatske	owningCompany	Croatian_Government
Noel_Murless	raceHorse	Twilight_Alley
Leonard_Hoffmann,_Baron_Hoffmann	predecessor	Donald_Nicholls,_Baron_Nicholls_of_Birkenhead
1982–83_Galatasaray_S.K._season	predecessor	1981–82_Galatasaray_S.K._season
Foxy_Foxy	album	Educated_Horses
New_Zealand_Media_and_Entertainment	predecessor	New_Zealand_Media_and_Entertainment
Martin_Luther_King_III	occupation	Community
CMLL_Mini-Estrellas_Tournaments	followingEvent	La_Copa_Junior
Incomplete_(Backstreet_Boys_song)	writer	Jess_Cates
Lonquimay	isPartOf	Malleco_Province
Saturday_Night_(Bay_City_Rollers_song)	producer	Bill_Martin_(musician)
Dywane_Thomas,_Jr.	associatedBand	David_Fiuczynski
WXXS	broadcastArea	Northeast_Kingdom
James_Stopford_(Australian_politician)	occupation	Miner
Komm_zurück/Die_Banane	recordLabel	Die_Ärzte_discography
Bolong_River	sourceMountain	Crookwell,_New_South_Wales
Gyeongbu_High_Speed_Railway	owner	Korea_Rail_Network_Authority
Aziz_Sattar	birthPlace	Pekalongan
Ace_Ventura,_Jr.:_Pet_Detective	starring	Cullen_Douglas
Looney_Tunes_Super_Stars'_Pepe_Le_Pew:_Zee_Best_of_Zee_Best	starring	Pepé_Le_Pew
Road_to_Bali	director	Hal_Walker
Shelley_Hammonds	team	Sydney_Uni_Flames
You_Are_the_Apple_of_My_Eye	writer	Giddens_Ko
Fucus	family	Fucaceae
Tomtemaskinen	subsequentWork	Håll_huvudet_kallt
Drupal	genre	Community
Mortician_(band)	formerBandMember	Mortician_(band)
Stay_a_Little_Longer_(Brothers_Osborne_song)	musicalArtist	Brothers_Osborne
Fortune_Brands	successor	Beam_Suntory
Happiness_Ltd.	subsequentWork	Future_Breeds
Margherita_of_Savoy	parent	Prince_Ferdinando,_Duke_of_Genoa_(1822–1855)
Sasha_Grey	birthPlace	North_Highlands,_California
Once_Upon_a_Christmas_Song	subsequentWork	The_Official_BBC_Children_in_Need_Medley
Henry_I_of_Cyprus	parent	Hugh_I_of_Cyprus
Cardiss_Collins	successor	Danny_K._Davis
Off_the_Ground_(song)	subsequentWork	Biker_Like_an_Icon
National_Geospatial-Intelligence_Agency	location	Fort_Belvoir
The_Planet_Smashers	recordLabel	Union_Label_Group
Saint_Alvia	recordLabel	Union_Label_Group
Voices_of_Babylon	producer	David_Leonard_(record_producer)
Freaks_and_Geeks	openingTheme	Bad_Reputation_(Joan_Jett_song)
Alfred_James_Jones	predecessor	John_Fihelly
Malini_Fonseka	birthPlace	Kelaniya
Stay_a_Little_Longer_(Brothers_Osborne_song)	musicalBand	Brothers_Osborne
Synaspismos	ideology	Eco-socialism
Draggin'_the_Line	musicalArtist	Tommy_James
Kenbridge,_Virginia	isPartOf	Lunenburg_County,_Virginia
Big_Bullet	starring	Yu_Rongguang
Superlative_Stakes	location	Newmarket_Racecourse
The_Official_BBC_Children_in_Need_Medley	previousWork	Once_Upon_a_Christmas_Song
Now_I_Can_Dance	previousWork	If_I_Didn't_Love_You_(Tina_Arena_song)
Zopfiaceae	class	Pleosporomycetidae
Betten	neighboringMunicipality	Martisberg
N.O.R.E._y_la_Familia...Ya_Tú_Sabe	recordLabel	Roc-La-Familia
Punch_Brothers	bandMember	Chris_Eldridge
Arzu_Özyiğit	formerTeam	Galatasaray_S.K._(women's_basketball)
Dorothy_Gish	deathPlace	Rapallo
Ahmad_Ibrahim_(basketball)	league	Lebanese_Basketball_League
Euplerinae	order	Feliformia
Dundas_Street	routeJunction	Don_Valley_Parkway
Autodesk_Media_and_Entertainment	product	Autodesk_Media_and_Entertainment
SuperTuxKart	computingPlatform	MorphOS
Tiffany_&_Co.	location	Fifth_Avenue
Gravitational_Pull_vs._the_Desire_for_an_Aquatic_Life	producer	Brian_McBride_(musician)
Mississippi_Fred_McDowell	associatedMusicalArtist	R._L._Burnside
Roosevelt_County,_New_Mexico	largestCity	Portales,_New_Mexico
Bambina_(Idoli_song)	writer	Vlada_Divljan
Get_Lost!	starring	Sheila_Reid
It's_Good_to_Be_Us	subsequentWork	I'll_Walk
Marquis_Floyd	formerTeam	Rio_Grande_Valley_Dorados
College_Street_(Toronto)	routeStart	Dundas_Street
Run_Away_with_You	previousWork	Look_at_You_(Big_&_Rich_song)
Theo_van_Doesburg	movement	Concrete_art
Soulcalibur_II	composer	Junichi_Nakatsuru
Grantsville,_Maryland	isPartOf	Garrett_County,_Maryland
1994–95_Portsmouth_F.C._season	successor	1995–96_Portsmouth_F.C._season
Vickie_Winans	associatedBand	Winans_family
Tomorrow_(SR-71_album)	previousWork	Now_You_See_Inside
Flying_High_on_Your_Love	subsequentWork	Money_Talks_(The_Bar-Kays_album)
Steve_Doszpot	associate	Simon_Corbell
Peter_Simonini	managerClub	Bentley_University
Marlow,_Oklahoma	isPartOf	Stephens_County,_Oklahoma
Stranac_u_noći_(Idoli_song)	writer	Vlada_Divljan
Leonard_Betts	guest	Bill_Dow
E!_(Australia)	sisterStation	Universal_Channel_(Australia)
William_Ash_(actor)	birthPlace	Chadderton
Vasile_Cârlova	birthPlace	Wallachia
Go_–_The_Very_Best_of_Moby	subsequentWork	Go_–_The_Very_Best_of_Moby
Leonard_P._Zakim_Bunker_Hill_Memorial_Bridge	crosses	Charles_River
Who_Done_It_(Dallas)	guest	Gregory_Walcott
Love_at_Risk	related	Absolutely_Charming
Taïna_Adama_Soro	team	Sabé_Sports_de_Bouna
Second_Star_to_the_Right	writer	Andrew_Chambliss
2014–15_Stoke_City_F.C._season	chairman	Peter_Coates
Ossessione	musicComposer	Giuseppe_Rosati
Batman:_Assault_on_Arkham	starring	Hynden_Walch
1981–82_Galatasaray_S.K._season	successor	1982–83_Galatasaray_S.K._season
Ministry_of_Education_(Ontario)	location	Bay_Street
Dunston_Checks_In	editing	Jon_Poll
1996–97_Leicester_City_F.C._season	predecessor	1995–96_Leicester_City_F.C._season
F/X2	starring	Philip_Bosco
Battle_of_Mount_Ortigara	commander	Luigi_Cadorna
Neighborhood_Bike_Works	industry	List_of_youth_organizations
Augustine_Mahiga	predecessor	Bernard_Membe
Boris_Kriukow	occupation	Graphics
The_Heart_That_You_Own	album	If_There_Was_a_Way
Wilhelm_Karl,_Duke_of_Urach	deathPlace	Rapallo
Joakim_Åhlund	associatedMusicalArtist	Caesars_(band)
Svetozar_Boroević	award	Military_Merit_Cross_(Austria-Hungary)
Road_to_Utopia	director	Hal_Walker
Grenoble_Institute_of_Technology	state	Isère
Alva,_Oklahoma	isPartOf	Woods_County,_Oklahoma
Dobermann_(film)	director	Jan_Kounen
Wind_&_Wuthering	subsequentWork	Spot_the_Pigeon
Gotta_Get_Away_(Sweethearts_of_the_Rodeo_song)	subsequentWork	Satisfy_You_(Sweethearts_of_the_Rodeo_song)
Revelation_of_the_Last_Hero	starring	Frankie_Lam
Gulong_Itlog_Gulong	previousWork	Buruguduystunstugudunstuy
Sealink	successor	Sealink
Woods_County,_Oklahoma	countySeat	Alva,_Oklahoma
Viverrinae	order	Feliformia
Society_parakeet	family	Platycercinae
Joakim_Åhlund	associatedBand	Caesars_(band)
Srinivasa_Ramanujan	almaMater	Pachaiyappa's_College
Rum_(song)	subsequentWork	Stay_a_Little_Longer_(Brothers_Osborne_song)
Sabaash_Meena	writer	P._Neelakantan
Ilija_Garašanin	deathPlace	Grocka
ULTRAnumb	previousWork	Scrape_(Blue_Stahli_song)
Bread_(TV_series)	starring	Melanie_Hill
Wanderson_Miranda_Francisco	team	ND_Dravinja
Dobermann_(film)	starring	Vincent_Cassel
Mortimer_L._Neinken	award	Luff_Award
Joe_Cannon_(soccer)	team	Saint_Francis_High_School_(Mountain_View)
Pieter_De_Crem	primeMinister	Guy_Verhofstadt
Mississippi_Fred_McDowell	associatedBand	R._L._Burnside
Hell_Comes_to_Quahog	subsequentWork	Saving_Private_Brian
Baxter_Springs,_Kansas	isPartOf	Cherokee_County,_Kansas
The_Campfire_Headphase	previousWork	Geogaddi
Queens_County,_Prince_Edward_Island	country	North_Rustico
The_Miracle_of_Sound_in_Motion	producer	Steel_Pole_Bath_Tub
Djenné_Cercle	isPartOf	Mopti_Region
Beaumarchais_(film)	musicComposer	Jean-Claude_Petit
Ilija_Garašanin	monarch	Mihailo_Obrenović
No_Sleeep	subsequentWork	Unbreakable_(Janet_Jackson_song)
Shelduck	family	Tadorninae
My_Front_Porch_Looking_In	writer	Frank_J._Myers
Equestrian_at_the_1920_Summer_Olympics_–_Team_eventing	nextEvent	Equestrian_at_the_1924_Summer_Olympics_–_Team_eventing
Donald_Nicholls,_Baron_Nicholls_of_Birkenhead	successor	Leonard_Hoffmann,_Baron_Hoffmann
Twilight_Alley	trainer	Noel_Murless
Plex_(software)	operatingSystem	Amazon_Fire_TV
Buruguduystunstugudunstuy	subsequentWork	Gulong_Itlog_Gulong
Abd_al-Muhsin_as-Sa'dun	monarch	Faisal_I_of_Iraq
Rum_(song)	producer	Brothers_Osborne
2006–07_Hull_City_A.F.C._season	position	2006–07_Football_League
Tivoli,_Lazio	province	Metropolitan_City_of_Rome_Capital
William_V._Houston	birthPlace	Mount_Gilead,_Ohio
Simeon_Eben_Baldwin	successor	Marcus_H._Holcomb
WNTZ-TV	formerBroadcastNetwork	Channel_America
What_Part_of_No	subsequentWork	I_Guess_You_Had_to_Be_There
Giddens_Ko	notableWork	You_Are_the_Apple_of_My_Eye
STX_Europe	predecessor	STX_Europe
Alexander_De_Croo	successor	Guy_Verhofstadt
Mike_Glita	associatedMusicalArtist	Senses_Fail
MorphOS	programmingLanguage	Lua_(programming_language)
Egay_Billones	formerTeam	Barako_Bull_Energy
KTHE	city	Thermopolis,_Wyoming
Blossom-headed_parakeet	genus	Psittacula
Okinori_Kaya	primeMinister	Senjūrō_Hayashi
Cornelia_Cole_Fairbanks	birthPlace	Marysville,_Ohio
Rum_(song)	musicalArtist	Brothers_Osborne
National_Geospatial-Intelligence_Agency	headquarter	Fort_Belvoir
Un_inviato_molto_speciale	network	Rai_2
Fugget_About_It	company	9_Story_Media_Group
DZEC-AM	broadcastArea	Mega_Manila
Dusky_starfrontlet	family	Trochilinae
Chris_Eldridge	associatedMusicalArtist	Punch_Brothers
Trans_Canada_Highway_(EP)	previousWork	The_Campfire_Headphase
Airport_Rail_Link_(Bangkok)	isPartOf	Airport_rail_link
Traffic_Jam_(film)	musicComposer	Fiorenzo_Carpi
The_Clambakes_Series_Vol._1	subsequentWork	The_Clambakes_Series_Vol._2
Donyo_Donev	birthPlace	Montana_Province
The_Miracle_of_Sound_in_Motion	artist	Steel_Pole_Bath_Tub
Portales,_New_Mexico	isPartOf	Roosevelt_County,_New_Mexico
Attica_Meli	trainer	Noel_Murless
Qualunquemente	producer	Domenico_Procacci
The_Campfire_Headphase	subsequentWork	Trans_Canada_Highway_(EP)
Olympic_Highway	city	Wagga_Wagga
1950_Swiss_Grand_Prix	location	Circuit_Bremgarten
Mere_Angne_Mein	starring	Mere_Angne_Mein
Wow_(Superbus_album)	previousWork	Pop'n'gum
Paul_S._Walsh	hometown	Chadderton
Keigo_Numata	team	Kamatamare_Sanuki
Eunymphicus	family	Platycercinae
The_Fall_of_Italy	writer	Lordan_Zafranović
Mislinja_(settlement)	isPartOf	Mislinja_(settlement)
Anne_of_Green_Gables:_A_New_Beginning	producer	Trudy_Grant
Great_Grand_Masti	writer	Mastizaade
The_Dibidus	associatedMusicalArtist	Prljavi_Inspektor_Blaža_i_Kljunovi
Days_of_the_New_(1999_album)	subsequentWork	Days_of_the_New_(2001_album)
Paraceltitidae	order	Ceratitida
Dover_Publications	parentCompany	Dover_Publications
Daniel_S._Dickinson	birthPlace	Goshen,_Connecticut
Unbreakable_(Janet_Jackson_song)	previousWork	No_Sleeep
Killed_or_Cured	subsequentWork	Killed_or_Cured
The_Song_of_the_Rivers	producer	World_Federation_of_Trade_Unions
America's_Funniest_People	presenter	Tawny_Kitaen
Ali_Vâsib	successor	Mehmed_Orhan
Whitworth,_Lancashire	district	Rossendale
Drupal	genre	Content_management_system
Forward_Motion	subsequentWork	Fire_It_Up_(Thousand_Foot_Krutch_song)
Charles_Frank_Ltd	product	Binoculars
Angus,_Thongs_and_Perfect_Snogging	cinematography	Dick_Pope_(cinematographer)
2006–07_Leicester_City_F.C._season	position	2006–07_Football_League
Adolf_Heyrowsky	award	Military_Merit_Cross_(Austria-Hungary)
Jack_Hobbs_(horse)	damsire	Swain_(horse)
2011–12_Stoke_City_F.C._season	chairman	Peter_Coates
The_Mercy_Seat_(song)	subsequentWork	Deanna_(song)
Tim_Vesely	hometown	Etobicoke
Rush_(The_X-Files)	guest	Bill_Dow
WBAK	city	Belfast,_Maine
Freaks_and_Geeks	creator	Paul_Feig
Deanna_(song)	subsequentWork	The_Ship_Song
Wilson_Grosset	team	AS_Poissy
Iron_Sky:_The_Coming_Race	musicComposer	Laibach_(band)
Beam_Suntory	foundedBy	Fortune_Brands
Eddie_Moten	formerTeam	Portland_Steel
Voices_of_Babylon	subsequentWork	Diamond_Days_(The_Outfield_album)
Amazon_Fire_TV	cpu	Multi-core_processor
Laid	subsequentWork	Wah_Wah
Growing_Up_Fisher	composer	Mateo_Messina
Catfish_and_the_Bottlemen	bandMember	Catfish_and_the_Bottlemen
Caesars_(band)	bandMember	Joakim_Åhlund
Geogaddi	subsequentWork	The_Campfire_Headphase
And_Then_There_Were_None	publisher	Collins_Crime_Club
Welcome_Home_(1989_film)	starring	Kieu_Chinh
Equestrian_at_the_1924_Summer_Olympics_–_Team_eventing	previousEvent	Equestrian_at_the_1920_Summer_Olympics_–_Team_eventing
The_Dibidus	associatedBand	Prljavi_Inspektor_Blaža_i_Kljunovi
Craig_McCracken	spouse	Lauren_Faust
Todd_McFarlane	award	Inkpot_Award
Ralph_Flanders	deathPlace	Springfield,_Vermont
First_Impressions_(Angel)	writer	Shawn_Ryan
Teen_Titans:_Trouble_in_Tokyo	starring	Hynden_Walch
Athletics_at_the_1976_Summer_Olympics_–_Women's_4_×_400_metres_relay	nextEvent	Athletics_at_the_1980_Summer_Olympics_–_Women's_4_×_400_metres_relay
Ayeshteni	artist	Natacha_Atlas
2006–07_Crystal_Palace_F.C._season	position	2006–07_Football_League
I_Guess_You_Had_to_Be_There	previousWork	What_Part_of_No
Bánh_chuối	ingredient	White_bread
ABBA:_The_Movie	writer	Robert_Caswell
But_Not_in_Vain	starring	Bruce_Lester
2013_Real_Salt_Lake_season	successor	2014_Real_Salt_Lake_season
U.S._Route_60_in_Texas	routeJunction	Hereford,_Texas
A._Harry_Moore	deathPlace	Branchburg,_New_Jersey
Bermudo_II_of_León	parent	Urraca_Fernández
Viktor_Prodell	team	Eskilstuna_City_FK
The_Woodwright's_Shop	composer	Rod_Abernethy
Atanas_Semerdzhiev	party	Bulgarian_Socialist_Party
Laibach_(band)	bandMember	Laibach_(band)
Love_Me_Like_You_Used_To_(song)	writer	Paul_Davis_(singer)
Rum_(song)	musicalBand	Brothers_Osborne
Bop_(song)	writer	Paul_Davis_(singer)
Thai_Airways	parentCompany	Ministry_of_Finance_(Thailand)
Cibao_International_Airport	location	Santiago_Province_(Dominican_Republic)
Sligo_Creek	riverMouth	Northwest_Branch_Anacostia_River
List_of_Sanrio_characters	occupation	Chocolatier
Beaumarchais_(film)	writer	Sacha_Guitry
Mike_Glita	associatedBand	Senses_Fail
The_Fall_of_Italy	director	Lordan_Zafranović
Marcus_H._Holcomb	birthPlace	New_Hartford,_Connecticut
Saving_Private_Brian	writer	Cherry_Chevapravatdumrong
The_Job_(2001_TV_series)	starring	Adam_Ferrara
If_I_Didn't_Love_You_(Tina_Arena_song)	subsequentWork	Now_I_Can_Dance
Ace_Ventura,_Jr.:_Pet_Detective	starring	Ace_Ventura,_Jr.:_Pet_Detective
Antonio_Narcisse	formerTeam	Portland_Steel
Carl_Harvey	associatedMusicalArtist	Willi_Williams
The_Bedevilled_(film)	director	Lo_Wei
Muhammad_Amin_Bughra	birthPlace	Hotan
Eastern_bluebonnet	family	Platycercinae
Passaic_River	rightTributary	Dead_River_(New_Jersey)
Typhoon_Generation	previousWork	Sunrise_Nippon/Horizon
Daniel_S._Dickinson	governor	Edwin_D._Morgan
Mehmed_Orhan	predecessor	Ali_Vâsib
Saturday_Night_(Bay_City_Rollers_song)	writer	Bill_Martin_(musician)
Bridgeport,_Michigan	isPartOf	Saginaw_County,_Michigan
Carrozza	trainer	Noel_Murless
Joel_Edgerton	relative	Nash_Edgerton
Manny_Pérez	birthPlace	Santiago_Province_(Dominican_Republic)
Alexander_De_Croo	predecessor	Guy_Verhofstadt
Pancho_and_Lefty	subsequentWork	If_I_Needed_You
Wah_Wah	previousWork	Laid
Junior_Sandoval	team	Atlanta_Silverbacks_Reserves
Loose_Cannons_(2010_film)	producer	Domenico_Procacci
William_Hall_(governor)	deathPlace	Sumner_County,_Tennessee
S._N._Balagangadhara	mainInterest	Religious_studies
Jack_Stewart_(politician)	birthPlace	Lithgow,_New_South_Wales
Satisfy_You_(Sweethearts_of_the_Rodeo_song)	previousWork	Gotta_Get_Away_(Sweethearts_of_the_Rodeo_song)
Tomorrow_(Chris_Young_song)	writer	Frank_J._Myers
Long-eared_gymnure	family	Erinaceidae
Muhlenberg_County,_Kentucky	largestCity	Central_City,_Kentucky
Robert_O._Davis	deathPlace	Beaver,_Pennsylvania
Houston_Hotshots	league	Premier_Arena_Soccer_League
Journey_into_Space	starring	Don_Sharp
John_Lindsay	otherParty	Liberal_Party_of_New_York
Bolong_River	sourcePlace	Crookwell,_New_South_Wales
Operation_Mongoose_(Once_Upon_a_Time)	guest	Agnes_Bruckner
Taxiarchis_Fountas	birthPlace	Missolonghi
Régiment_de_marche_du_Tchad	battle	Fezzan
Hanife_Demiryol	team	Turkey_women's_national_football_team
Autumn_Moon_Entertainment	product	A_Vampyre_Story
Chris_Wallace_(American_football)	team	Florida_Tarpons
SportN	sisterStation	Viasat_Motor
List_of_Sanrio_characters	species	Rabbit
Whenever_You_Need_Me_(T'Pau_song)	writer	Carol_Decker
Geoffrey_Rice	birthPlace	Taumarunui
Mr._Turner	cinematography	Dick_Pope_(cinematographer)
Maître_Gims	recordLabel	Wati_B
Secrets_(OneRepublic_song)	subsequentWork	Marchin_On
Brother_(2000_film)	producer	Masayuki_Mori_(film_producer)
This_Place_Hotel	previousWork	Lovely_One
The_Great_War_(1959_film)	cinematography	Roberto_Gerardi
History_of_Derby_County_F.C._(1967–present)	location	Baseball_Ground
Herbert_H._Lehman	successor	Fiorello_H._La_Guardia
KSHR-FM	sisterStation	KTEE
Pursuit_to_Haritan	commander	Faisal_I_of_Iraq
Bunny_Adair	occupation	Miner
Because_You_Love_Me	album	I'm_Alright_(Jo_Dee_Messina_album)
High_Time_(song)	album	Kilroy_Was_Here_(album)
Channel_Highway	city	Kingston,_Tasmania
Teen_Titans:_Trouble_in_Tokyo	composer	Puffy_AmiYumi
Good_Morning,_Miss_Dove	starring	Peggy_Knudsen
Sylvanus_Morley	field	Epigraphy
Fifth_Avenue	routeJunction	Midtown_Manhattan
Li'l_Sebastian	subsequentWork	I'm_Leslie_Knope
The_Wizards_Return:_Alex_vs._Alex	starring	David_DeLuise
A_Vampyre_Story	developer	Autumn_Moon_Entertainment
Brian_Charlton	spouse	Chris_Charlton
Amazon_Fire_TV	type	Digital_media_player
AES_Corporation	type	S&P_500_Index
Chevron_Corporation	predecessor	Chevron_Corporation
Les_Misérables_(miniseries)	musicComposer	Jean-Claude_Petit
Ellen_G._White	birthPlace	Gorham,_Maine
Sail_On,_Sailor	album	Holland_(album)
Un_inviato_molto_speciale	executiveProducer	Rai_2
Battle_of_Guam_(1941)	place	Mariana_Islands
Daniel_Gimeno-Traver	residence	Nules
Robert_Spencer_(author)	almaMater	Religious_studies
Gail_Huff	almaMater	Bentley_University
Assembly_of_the_Republic_(Portugal)	politicalPartyInLegislature	Portuguese_Communist_Party
U.S._Route_61_in_Minnesota	routeJunction	Denmark_Township,_Washington_County,_Minnesota
Solegnathus	family	Syngnathidae
It's_a_Trap!	writer	Cherry_Chevapravatdumrong
38_Studios	keyPerson	Todd_McFarlane
Tapi_Dharma_Rao	almaMater	Pachaiyappa's_College
Jenna_McMahon	award	The_Carol_Burnett_Show
Shelter_Skelter	guest	Danica_McKellar
HP_Enterprise_Business	product	Computer_network
Fuck_Pussy_Galore_(&_All_Her_Friends)	artist	Unrest_(band)
Castleton_Lyons	keyPerson	Tony_Ryan
Tetris_Ultimate	series	Tetris
Lost_Girl_(Once_Upon_a_Time)	writer	Andrew_Chambliss
Phan_Văn_Tài_Em	team	Xuân_Thành_Sài_Gòn_F.C.
The_MOFO_Project/Object	recordLabel	Zappa_Records
Attakathi	producer	C._V._Kumar
Scary_Movie_4	starring	Regina_Hall
Niorouhio	isPartOf	Gagnoa_Department
Cüneyt_Arkın	award	International_Antalya_Film_Festival
Daniel_Patrick_Moynihan	successor	Bob_Packwood
Trixter	recordLabel	Backstreet_Records
Royal_Lodge_Stakes	location	Newmarket_Racecourse
Kevin_Sammut	team	Malta_national_under-17_football_team
Lam_Brook	sourceRegion	South_Gloucestershire
Bariwali	director	Rituparno_Ghosh
Harvey_Jerome_Brudner	employer	Westinghouse_Electric_(1886)
The_Return_of_Don_Camillo	starring	Paolo_Stoppa
Rebell	recordLabel	Die_Ärzte_discography
Fourth_Crusade	commander	Kaloyan_of_Bulgaria
The_Wager_(2007_film)	starring	Candace_Cameron_Bure
KKLX	broadcastNetwork	NBC_Red_Network
KKZQ	programmeFormat	Mainstream_rock
1953_Swiss_Grand_Prix	location	Circuit_Bremgarten
The_Others_(TV_series)	starring	John_Billingsley
Muthuchippikal	starring	Hari_(actor)
Gail_Huff	residence	Rye,_New_Hampshire
Malheur_Lake	inflow	Donner_und_Blitzen_River
Emmer_Bowen	restingPlace	Angelus-Rosedale_Cemetery
The_Return_of_Don_Camillo	writer	René_Barjavel
Abdulfatah_Safi	team	AS_Poissy
Marian_Ilitch	occupation	Detroit_Tigers
Hard_candy	ingredient	Flavor
Bread_(TV_series)	starring	Gilly_Coman
John_Donnelly_(footballer,_born_1961)	team	Vale_of_Clyde_F.C.
The_Land_Girls	starring	Catherine_McCormack
David_Park_(painter)	influenced	Manuel_Neri
Copper_Harbor,_Michigan	isPartOf	Keweenaw_County,_Michigan
Vasile_Cârlova	nationality	Wallachia
Shelley_Hammonds	team	Dandenong_Rangers
John_A._Pittman	birthPlace	Carrollton,_Mississippi
Bill_Morrison_(politician)	birthPlace	Lithgow,_New_South_Wales
Harpellales	division	Zygomycota
With_Just_One_Look_in_Your_Eyes	writer	Stephen_Allen_Davis
WHJY	programmeFormat	Mainstream_rock
ZSNES	genre	Video_game_console_emulator
Maine_State_Route_43	routeJunction	Farmington,_Maine
Hippocampinae	family	Syngnathidae
David_B._Sentelle	birthPlace	Canton,_North_Carolina
